source,destination,hamming_distance_ups,hamming_distance_downs,hamming_distance_LR,hamming_distance_total,fitts_ratio,normalized_fitts_ratio
0,1,0,1,3,4,1.1614040976895261,0.7943344322220799
0,2,0,2,4,6,3.4232325263972285,2.3412966000631505
0,3,0,2,5,7,3.610915531187356,2.4696611144852048
0,4,0,2,6,8,3.7727091687127294,2.5803187722776424
0,5,0,1,0,1,0.5939246123705618,0.40621069848869
0,6,0,1,1,2,1.0385170520494775,0.7102866732894852
0,7,0,1,2,3,0.4462997547326014,0.30524368131783935
0,8,0,1,7,8,3.8096061704005204,2.605554225592018
0,9,0,1,8,9,6.51627976733449,4.456765220204672
0,10,0,1,9,10,6.121294047580841,4.186617424049558
0,11,0,1,11,12,0.05849614480133854,0.04000804031980716
0,12,0,1,10,11,0.0034697022857740544,0.002373079275880741
0,13,0,2,30,32,0.15886780985797688,0.1086565578621167
0,14,0,2,11,13,0.2378436836977153,0.1626715695454158
0,15,0,3,4,7,8.253391558760692,5.6448510133354635
0,16,0,2,10,12,0.024856349070270563,0.01700033086255336
0,17,0,2,29,31,0.412076786994975,0.281837115333698
0,18,0,2,34,36,0.7294027450267835,0.4988700457357631
0,19,0,2,35,37,1.2793945135867109,0.8750331745511191
0,20,0,2,32,34,0.7302143006398981,0.49942510367678683
0,21,0,2,33,35,0.5882250840238796,0.4023125448467301
0,22,0,3,30,33,0.6058317412990442,0.41435449832168275
0,23,0,2,38,40,0.722638184834261,0.4942434708076661
0,24,0,2,37,39,0.6429243964214524,0.43972376747174224
0,25,0,2,12,14,0.6248727371377982,0.42737745790018683
0,26,0,2,31,33,2.0453146374827362,1.3988790331568761
0,27,0,3,18,21,1.0073281676977517,0.688955247997932
0,28,0,1,13,14,0.9067456781169903,0.6201625384564714
0,29,0,2,14,16,0.8397181256899514,0.5743194999255357
0,30,0,4,16,20,1.716774116782856,1.174175978904479
0,31,0,1,15,16,0.43339459045682865,0.29641728199815226
0,32,0,2,11,13,0.9661775995241347,0.6608105968202466
0,33,0,3,12,15,1.226302955474551,0.8387215645329479
0,34,0,2,42,44,1.1397328414709014,0.7795125239489766
0,35,0,2,40,42,0.6145264411834371,0.4203011791623568
0,36,0,3,19,22,1.565047778130353,1.0704037816938494
0,37,0,1,16,17,1.0532947940952597,0.7203938094368548
0,38,0,2,7,9,1.634458334323403,1.1178766594402856
0,39,0,2,36,38,0.45541358521478986,0.311477023679761
0,40,0,2,13,15,0.8637613302786685,0.5907636861513048
0,41,0,2,16,18,1.0871738913086948,0.7435651875151371
0,42,0,2,17,19,0.4394946593026536,0.3005893825898442
0,43,0,2,21,23,1.745108782833661,1.1935552810047936
0,44,0,3,31,34,0.5776884338718684,0.3951060746502922
0,45,0,2,39,41,1.4620464149225068,0.99995669998941
0,46,0,2,19,21,1.3698982907155617,0.9369326172710272
0,47,0,1,12,13,1.0975687304472352,0.7506746670335741
0,48,0,2,41,43,1.0921172098268577,0.7469461365889604
0,49,0,3,11,14,1.3798070586815334,0.9437096517174602
0,50,0,4,17,21,1.4823460863277023,1.0138405221595046
0,51,0,3,17,20,2.0431413687977056,1.3973926408232997
0,52,0,2,15,17,1.1337888123481892,0.7754471456644553
0,53,0,1,17,18,1.968016260095429,1.3460113337611326
0,54,0,3,10,13,2.343552551595868,1.6028568257662166
0,55,0,2,2,4,0.787098186584568,0.5383304505188848
0,56,0,3,16,19,0.7878083908831303,0.5388161899177576
0,57,0,2,18,20,0.892635513020769,0.6105119870225959
0,58,0,2,3,5,0.897622994812592,0.6139231412670204
0,59,0,2,28,30,1.2807618688126967,0.8759683678565673
0,60,0,2,27,29,1.0972756374142691,0.7504742080474275
0,61,0,2,26,28,1.254029299902022,0.85768480919706
0,62,0,2,25,27,1.1318034972971855,0.7740893029403266
0,63,0,2,24,26,1.3867357043013582,0.9484484517573778
0,64,0,2,23,25,1.5118727221131738,1.0340350638515305
0,65,0,3,15,18,1.6448954382786456,1.1250150456926018
0,66,0,3,14,17,1.7852133784064375,1.2209845463373097
0,67,0,3,13,16,1.9533447098644816,1.3359768267831549
0,68,0,2,22,24,1.7338798137349396,1.1858753039742178
0,69,0,2,20,22,1.5933075741453944,1.089731876942503
0,70,0,1,5,6,0.17842613537419097,0.12203334155441056
0,71,0,1,4,5,2.1800769187100597,1.4910487786886977
0,72,0,1,6,7,1.2953029479796427,0.885913640037844
0,73,0,1,14,15,4.3598359985945025,2.9818801736746976
1,0,1,0,0,1,0.0007509390541232015,0.0005135996578426042
1,2,0,1,1,2,4.2743111968552,2.923386067303242
1,3,0,1,2,3,4.496213716779988,3.0751547863251245
1,4,0,1,3,4,4.677687775603417,3.1992727343892966
1,5,0,0,3,3,0.47867228279827223,0.32738465167586905
1,6,0,0,2,2,0.6769499984400058,0.46299534651489394
1,7,0,0,1,1,0.0666914554464694,0.04561316728735798
1,8,0,0,4,4,0.3227592813832133,0.22074901494835097
1,9,0,0,5,5,1.4791829680896207,1.0116771289575208
1,10,0,0,6,6,1.7530972873945885,1.1990189643578415
1,11,0,0,8,8,0.05928539353524289,0.04054784162253642
1,12,0,0,7,7,0.003315464142794885,0.00226758914718731
1,13,0,1,27,28,0.09965661707348195,0.06815946533830748
1,14,0,1,8,9,0.29355934143962753,0.20077791465505102
1,15,0,2,1,3,10.258417952534831,7.016175176266586
1,16,0,1,7,8,0.03399800274981495,0.02325270271104066
1,17,0,1,26,27,0.1505735473980088,0.10298375347392268
1,18,0,1,31,32,0.11866430045480537,0.08115964108815817
1,19,0,1,32,33,0.3614200133901989,0.24719075961685338
1,20,0,1,29,30,0.28055131127186583,0.19188116090827817
1,21,0,1,30,31,0.13134057971014493,0.08982949605509874
1,22,0,2,27,29,0.3698514883798498,0.25295740958134266
1,23,0,1,35,36,0.15983729248659226,0.1093196289111016
1,24,0,1,34,35,0.18561845293354978,0.12695247822375735
1,25,0,1,9,10,0.7230246782893457,0.49450781037716907
1,26,0,1,28,29,0.49965648326453843,0.34173665284080873
1,27,0,2,15,17,1.4460600807620936,0.9890229554866256
1,28,0,0,10,10,1.8681382962097601,1.2777004797763303
1,29,0,1,11,12,0.749127383516778,0.5123605780551385
1,30,0,3,13,16,2.3167987447361744,1.5845587415559477
1,31,0,0,12,12,0.7774350143905872,0.531721389630052
1,32,0,1,8,9,1.1864942137031003,0.8114946463953179
1,33,0,2,9,11,1.5470995991257268,1.0581282467552158
1,34,0,1,39,40,0.39647883721300325,0.27116900368458347
1,35,0,1,37,38,0.8364501896425671,0.572084417295897
1,36,0,2,16,18,2.365390502726863,1.6177927438907016
1,37,0,0,13,13,1.9677835555479446,1.3458521770688414
1,38,0,1,4,5,2.10574040688298,1.4402068270949306
1,39,0,1,33,34,0.20364617108391173,0.1392824134200559
1,40,0,1,10,11,0.8973058739978849,0.6137062486429997
1,41,0,1,13,14,0.6507633699457092,0.4450851800894364
1,42,0,1,14,15,0.1206942878147558,0.08254803713410984
1,43,0,1,18,19,0.4939413448236544,0.33782782278110646
1,44,0,2,28,30,0.3847661685542576,0.26315820363027087
1,45,0,1,36,37,0.45226541444382057,0.309323853696229
1,46,0,1,16,17,0.13662643027932905,0.0934447175951609
1,47,0,0,9,9,2.148781348746825,1.469644386498876
1,48,0,1,38,39,0.4971116574774726,0.3399961365547938
1,49,0,2,8,10,1.7662371883812045,1.2080059102541252
1,50,0,3,14,17,2.000439360028111,1.3681868924035918
1,51,0,2,14,16,2.8178747999919644,1.9272663010036062
1,52,0,1,12,13,0.8377930468493472,0.5730028553477561
1,53,0,0,14,14,2.615510657596333,1.7888607223839643
1,54,0,2,7,9,3.0170005614091706,2.063457010981977
1,55,0,1,1,2,0.16119912808400869,0.11025104710413673
1,56,0,2,13,15,1.0639111611699426,0.7276548014802836
1,57,0,1,15,16,0.14333769086537113,0.09803483861997347
1,58,0,1,2,3,0.08452380952380953,0.05780948455486749
1,59,0,1,25,26,0.8016376782285201,0.5482746369246089
1,60,0,1,24,25,0.8547839903542973,0.5846236955779323
1,61,0,1,23,24,1.1752544808281449,0.8038073075532071
1,62,0,1,22,23,1.2296950072237487,0.8410415352525511
1,63,0,1,21,22,1.6715769570313124,1.1432636889438055
1,64,0,1,20,21,1.9204537842821878,1.313481301970004
1,65,0,2,12,14,2.1384359617635913,1.4625687294456655
1,66,0,2,11,13,2.3432025295963284,1.6026174306006382
1,67,0,2,10,12,2.563228216310223,1.7531025023149938
1,68,0,1,19,20,0.5172338131580808,0.3537585480525989
1,69,0,1,17,18,0.17991957617309495,0.1230547702297654
1,70,0,0,2,2,0.22900196952797774,0.15662433928433755
1,71,0,0,1,1,2.7434815558907544,1.8763855477568667
1,72,0,0,3,3,0.11817038941140025,0.08082183398982615
1,73,0,0,11,11,9.284065259528052,6.349773279869546
2,0,2,0,0,2,0.00093195324178108,0.000637403080151348
2,1,1,0,1,2,1.7997099776232421,1.2308993967592596
2,3,1,1,1,3,0.16670970518685901,0.114019968828209
2,4,1,1,2,4,0.40911177841417684,0.2798092178841821
2,5,1,0,4,5,0.6632815234728707,0.453646886040232
2,6,1,0,3,4,1.3214375458388896,0.9037882204643948
2,7,1,0,2,3,0.6794006973956321,0.46467148539483877
2,8,1,0,3,4,5.918183563747823,4.047701390280765
2,9,1,0,4,5,10.027799419028664,6.858445199045962
2,10,1,0,5,6,9.351870187000728,6.39614799877489
2,11,1,0,7,8,0.1262425766824771,0.08634275156323325
2,12,1,0,6,7,0.005142781846226701,0.003517370660213184
2,13,1,1,26,28,0.2769957280567302,0.18944934395496124
2,14,1,1,7,9,0.4999971094840719,0.341969621826566
2,15,0,1,0,1,0.058333333333333334,0.03989668652378178
2,16,1,1,6,8,0.005437180487988473,0.003718722608614268
2,17,1,1,25,27,0.6886383201430107,0.4709894946344466
2,18,1,1,30,32,1.272805032096283,0.8705263435103556
2,19,1,1,31,33,2.176838277230487,1.4888337318794387
2,20,1,1,28,30,1.2853707720510228,0.8791205958745892
2,21,1,1,29,31,1.0413641652763443,0.712233937013657
2,22,1,2,26,29,1.0289374838536172,0.703734792786455
2,23,1,1,34,36,1.3134933410354404,0.8983548356291274
2,24,1,1,33,35,1.1956699946519989,0.8177703593575308
2,25,1,1,8,10,0.4712495144721239,0.32230789977220614
2,26,1,1,27,29,3.3972454323395627,2.323522903858304
2,27,1,2,14,17,0.23440775479159404,0.1603215893428069
2,28,1,0,9,10,1.010888155807368,0.6913900776488646
2,29,1,1,10,12,1.0151756659086453,0.6943224910170626
2,30,1,3,12,16,0.3371654720690652,0.2306020310705554
2,31,1,0,11,12,0.562294557401062,0.3845775375541508
2,32,1,1,7,9,0.515103635022456,0.3523016272071674
2,33,1,2,8,11,0.4465295708553723,0.30540086249169596
2,34,1,1,38,40,2.058944140662669,1.408200839142785
2,35,1,1,36,38,0.9635496120793529,0.6590132026841397
2,36,1,2,15,18,0.8188726426966173,0.5600623736325894
2,37,1,0,12,13,1.4848359736535524,1.0155434636586873
2,38,1,1,3,5,0.19710699120222908,0.13480998582241965
2,39,1,1,32,34,0.8546583427195497,0.5845377597328583
2,40,1,1,9,11,0.8615796316607545,0.5892715282224771
2,41,1,1,12,14,1.5873338923296165,1.0856462179002702
2,42,1,1,13,15,0.7053928771338077,0.48244865991627506
2,43,1,1,17,19,2.766243336148752,1.8919533125284644
2,44,1,2,27,30,1.055273919706718,0.7217474189359098
2,45,1,1,35,37,2.5592593994101867,1.75038805699389
2,46,1,1,15,17,2.234804345994529,1.5284792302993524
2,47,1,0,8,9,1.0230163732805062,0.6996850894880312
2,48,1,1,37,39,2.215152364962736,1.5150383915542651
2,49,1,2,7,10,0.3180793663999057,0.21754821893040285
2,50,1,3,13,17,0.39277672978196987,0.2686369724905268
2,51,1,2,13,16,0.33181818181818185,0.22694478827813533
2,52,1,1,11,13,1.5371629134497122,1.0513321181809077
2,53,1,0,13,14,3.9396878048901285,2.6945226746274415
2,54,1,2,6,9,0.11277173598360139,0.07712946170195019
2,55,1,1,2,4,1.1886045833867087,0.812938019384739
2,56,1,2,12,15,0.17975430709409262,0.12294173556741629
2,57,1,1,14,16,1.4513052684561305,0.9926103659298379
2,58,1,1,3,5,1.3809544334960115,0.9444943909168635
2,59,1,1,24,26,1.971218488094641,1.3482014758181997
2,60,1,1,23,25,1.569170332445322,1.0732233746741051
2,61,1,1,22,24,1.5934060753362176,1.0897992461619173
2,62,1,1,21,23,1.1923856118159195,0.8155240280586428
2,63,1,1,20,22,1.0973246977749744,0.7505077625474013
2,64,1,1,19,21,0.8510057450224554,0.5820395903845419
2,65,1,2,11,14,0.6378306715431804,0.43623994899105417
2,66,1,2,10,13,0.44268519847514615,0.30277153015338903
2,67,1,2,9,12,0.15429330384404602,0.10552785559173461
2,68,1,1,18,20,2.768890689404376,1.893763951779162
2,69,1,1,16,18,2.6420199566866662,1.8069915771686307
2,70,1,0,1,2,0.020202308534863316,0.01381723149723708
2,71,1,0,0,1,0.02715518986740276,0.018572607388003603
2,72,1,0,2,3,2.0209079071769014,1.3821862159897498
2,73,1,0,10,11,5.396914122474728,3.6911827018310586
3,0,2,0,0,2,0.0009011280152243382,0.0006163203761349101
3,1,1,0,2,3,1.7353807327922761,1.1869018473535569
3,2,1,1,1,3,0.15281722975462075,0.1045183047591916
3,4,0,0,1,1,0.22727272727272727,0.15544163580694204
3,5,1,0,5,6,0.6224600393300617,0.42572730964684036
3,6,1,0,4,5,1.2500042165555465,0.8549318808226642
3,7,1,0,3,4,0.6527317745546902,0.4464314570317762
3,8,1,0,2,3,5.718181818181818,3.9109115569026613
3,9,1,0,3,4,9.72223214285208,6.6494545391109385
3,10,1,0,4,5,9.080255306288139,6.210378848758012
3,11,1,0,6,7,0.12334887775192595,0.0843636258639235
3,12,1,0,5,6,0.004851304612982641,0.0033180167892950564
3,13,1,1,25,27,0.26407179781092294,0.1806101097777236
3,14,1,1,6,8,0.4904160829777998,0.3354167439220498
3,15,1,2,1,4,0.37006005518624197,0.25310005742980946
3,16,1,1,5,7,0.0045535923786306455,0.003114398531782435
3,17,1,1,24,26,0.669123757132934,0.4576426420105332
3,18,1,1,29,31,1.2286403819027099,0.840320231438262
3,19,1,1,30,32,2.1105848505536544,1.4435201513894054
3,20,1,1,27,29,1.2315252629984677,0.8422933262394476
3,21,1,1,28,30,1.0018070897768063,0.6851791443107547
3,22,1,2,25,28,0.9805830968747846,0.6706631387405559
3,23,1,1,33,35,1.268125958326126,0.8673261228344196
3,24,1,1,32,34,1.1503872574111247,0.7867995392551663
3,25,1,1,7,9,0.42901794354793693,0.29342390411673513
3,26,1,1,26,28,3.2923780132065112,2.2517995458975713
3,27,1,2,13,16,0.2393480866608419,0.16370049571842116
3,28,1,0,8,9,0.9597777624522296,0.6564334717894852
3,29,1,1,9,11,0.9525754563287886,0.651507503509681
3,30,1,3,11,15,0.27500789130091846,0.1880897765279828
3,31,1,0,10,11,0.5629286438338613,0.385011216656523
3,32,1,1,6,8,0.4552398902712136,0.31135822620465303
3,33,1,2,7,10,0.3770538621793858,0.2578834241477516
3,34,1,1,37,39,1.9965712864399403,1.3655413497853377
3,35,1,1,35,37,0.9056620591766549,0.619421404653492
3,36,1,2,14,17,0.737585610521184,0.5044666609271294
3,37,1,0,11,12,1.4824147993257302,1.0138875179470892
3,38,0,0,2,2,0.13097188674138463,0.0895773310071304
3,39,1,1,31,33,0.8192330414983432,0.5603088659414351
3,40,1,1,8,10,0.7992265499980388,0.5466255621729491
3,41,1,1,11,13,1.5078406889898022,1.0312773822245018
3,42,1,1,12,14,0.6761229342525088,0.46242968158991765
3,43,1,1,16,18,2.684867158689226,1.836296629512355
3,44,1,2,26,29,1.0065841700628673,0.6884463958765589
3,45,1,1,34,36,2.4814162605583263,1.6971477717001777
3,46,1,1,14,16,2.1516235167972337,1.4715882680032484
3,47,1,0,7,8,0.9750645455843194,0.6668887631251085
3,48,1,1,36,38,2.1290692802255164,1.456162451324077
3,49,1,2,6,9,0.24756634966082056,0.16932132079293788
3,50,1,3,12,16,0.3242565842277681,0.22177308504355728
3,51,1,2,12,15,0.34873591087983774,0.23851555398785806
3,52,1,1,10,12,1.4528142960124757,0.9936424550619166
3,53,1,0,12,13,3.8744630595735456,2.649912653756198
3,54,1,2,5,8,0.15613341479051945,0.10678638695631341
3,55,1,1,3,5,1.140355621616311,0.7799384701929992
3,56,1,2,11,14,0.14697383164884315,0.10052175237416525
3,57,1,1,13,15,1.3950049427401898,0.9541041411365402
3,58,1,1,4,6,1.3285719619387906,0.9086677558244173
3,59,1,1,23,25,1.8735658311861543,1.281412605402903
3,60,1,1,22,24,1.4838107994368388,1.0148423027268618
3,61,1,1,21,23,1.496003724745206,1.0231815710497614
3,62,1,1,20,22,1.1073874278152172,0.7573900983072128
3,63,1,1,19,21,1.0007097489254253,0.6844286255000583
3,64,1,1,18,20,0.7553915740632908,0.5166449285675865
3,65,1,2,10,13,0.5442447681565863,0.3722325069831706
3,66,1,2,9,12,0.3545174146042096,0.24246977413175536
3,67,1,2,8,11,0.17807321371965085,0.12179196318951956
3,68,1,1,17,19,2.688157509896022,1.8385470428377961
3,69,1,1,15,17,2.544068113351114,1.7399980802317432
3,70,1,0,0,1,0.012922857168060917,0.008838500253012563
3,71,1,0,1,2,0.09813816043294914,0.0671209272482396
3,72,1,0,1,2,1.9445382231849981,1.329953690124403
3,73,1,0,9,10,5.120397803293743,3.5020612463155087
4,0,2,0,0,2,0.0008630459702540567,0.0005902744205286721
4,1,1,0,2,3,1.6549714059883434,1.1319064352663886
4,2,1,1,1,3,0.3437675360285792,0.2351174678054586
4,3,0,0,1,1,0.20833333333333334,0.1424881661563635
4,5,1,0,5,6,0.5714406186234586,0.39083292391158986
4,6,1,0,4,5,1.1607188266190351,0.7938657457349395
4,7,1,0,3,4,0.6193986834901044,0.4236335161448199
4,8,1,0,2,3,5.468181818181818,3.739925757515025
4,9,1,0,3,4,9.34028810408351,6.388226511950194
4,10,1,0,4,5,8.740749459436259,5.978176134275032
4,11,1,0,6,7,0.11971562277674097,0.08187868583867906
4,12,1,0,5,6,0.004486361363011153,0.0030684163359850684
4,13,1,1,25,27,0.24788522352482026,0.16953941240309714
4,14,1,1,6,8,0.47838361041563937,0.32718721616344654
4,15,1,2,1,4,0.8265137627408269,0.5652884657084934
4,16,1,1,5,7,0.003815465363136104,0.002609561580606658
4,17,1,1,24,26,0.6446864473786257,0.44092891023763836
4,18,1,1,29,31,1.1733409160230261,0.8024985379216738
4,19,1,1,30,32,2.0276243070594986,1.3867798520014811
4,20,1,1,27,29,1.1640947547685114,0.7961746888281932
4,21,1,1,28,30,0.9522723806430163,0.6513002169560541
4,22,1,2,25,28,0.9200275089821776,0.6292465563277332
4,23,1,1,33,35,1.211297549519614,0.8284587192035844
4,24,1,1,32,34,1.0936617027851385,0.7480024820414413
4,25,1,1,7,9,0.3761827918525478,0.2572876615231226
4,26,1,1,26,28,3.1611191310025157,2.16202592629606
4,27,1,2,13,16,0.25869925528988763,0.1769355958669105
4,28,1,0,8,9,0.9008721261260297,0.6161453625267945
4,29,1,1,9,11,0.8742355261038303,0.5979274411357365
4,30,1,3,11,15,0.2248649285929469,0.15379483827883508
4,31,1,0,10,11,0.5641021010093729,0.3858137947093309
4,32,1,1,6,8,0.38044466119299325,0.2602025380673695
4,33,1,2,7,10,0.2907031555759425,0.19882444576264363
4,34,1,1,37,39,1.9184133806168695,1.3120857817628522
4,35,1,1,35,37,0.8333668974722173,0.5699756205899253
4,36,1,2,14,17,0.6439814660669781,0.4404467430651367
4,37,1,0,11,12,1.4804005388122163,1.0125098781707769
4,38,0,0,1,1,0.09104258187616189,0.06226795456163944
4,39,1,1,31,33,0.7748548809326752,0.5299567249027406
4,40,1,1,8,10,0.7211973712727858,0.4932580361733566
4,41,1,1,11,13,1.4083732279223198,0.9632472888497737
4,42,1,1,12,14,0.6395015420014422,0.4373827294749704
4,43,1,1,16,18,2.5830757869760625,1.7666771132597983
4,44,1,2,26,29,0.9455953071713099,0.6467334779755354
4,45,1,1,34,36,2.3839078383261074,1.630457549610565
4,46,1,1,14,16,2.047558717095577,1.4004138561428405
4,47,1,0,7,8,0.9220909586971943,0.6306578387238064
4,48,1,1,36,38,2.0211966752396955,1.3823837169419677
4,49,1,2,6,9,0.1628738939050212,0.1113964917949084
4,50,1,3,12,16,0.24966259370976657,0.17075503265062028
4,51,1,2,12,15,0.40279242239296165,0.2754871373205719
4,52,1,1,10,12,1.3472660240817218,0.9214534324616623
4,53,1,0,12,13,3.792540573283297,2.593882326531555
4,54,1,2,5,8,0.2663912396828713,0.18219647626815666
4,55,1,1,3,5,1.080048868988294,0.7386920769667034
4,56,1,2,11,14,0.11487334850876553,0.0785668452924232
4,57,1,1,13,15,1.3245674619322834,0.9059289052853756
4,58,1,1,4,6,1.263095799111226,0.8638857796567926
4,59,1,1,23,25,1.7513234108562774,1.197805733566169
4,60,1,1,22,24,1.3769545101943386,0.9417586705839602
4,61,1,1,21,23,1.3740756691373683,0.9397897068262162
4,62,1,1,20,22,1.0010103843371363,0.6846342430448409
4,63,1,1,19,21,0.8799117335284378,0.6018096445916828
4,64,1,1,18,20,0.6362586077562152,0.4351647466578438
4,65,1,2,10,13,0.42909426813216406,0.2934761057969232
4,66,1,2,9,12,0.2530308939454159,0.17305875868410056
4,67,1,2,8,11,0.2537992563030869,0.17358427489188352
4,68,1,1,17,19,2.5871521014217547,1.7694650807960066
4,69,1,1,15,17,2.421497460698311,1.6561667161305278
4,70,1,0,0,1,0.00897658762545078,0.00613947604364346
4,71,1,0,1,2,0.2184536987439168,0.1494099212356579
4,72,1,0,1,2,1.8490569548554698,1.2646499261569237
4,73,1,0,9,10,4.796833506367756,3.280761646462756
5,0,1,0,0,1,0.0006052228542243757,0.00041393805414888685
5,1,0,0,3,3,0.7543987147025402,0.5159658691616766
5,2,0,1,4,5,2.4826995913324814,1.6980254970533686
5,3,0,1,5,6,2.5417118272644186,1.7383865143912645
5,4,0,1,6,7,2.5455082102317705,1.7409830246970819
5,6,0,0,1,1,0.16074707785617243,0.10994187042585696
5,7,0,0,2,2,0.24606060606060606,0.16829147770031588
5,8,0,0,7,7,2.6682437657358875,1.8249271729817096
5,9,0,0,8,8,5.062519051937936,3.462475468042985
5,10,0,0,9,9,4.938287037012924,3.3775078265170255
5,11,0,0,11,11,0.0820647677586378,0.0561276396670856
5,12,0,0,10,10,0.0008757677865790431,0.0005989754202646338
5,13,0,1,30,31,0.07306714308058844,0.049973775474420834
5,14,0,1,11,12,0.3588412657355359,0.24542704270024718
5,15,0,2,4,6,5.958356643311047,4.0751774947726895
5,16,0,1,10,11,0.018341605612006515,0.012544616390486754
5,17,0,1,29,30,0.3723465861661576,0.25466391473951133
5,18,0,1,34,35,0.5583255096784292,0.38186293436350255
5,19,0,1,35,36,1.1034059050812752,0.7546669629174404
5,20,0,1,32,33,0.42106548645134295,0.2879848751817071
5,21,0,1,33,34,0.4032598115797937,0.27580680497551435
5,22,0,2,30,32,0.26241283091182965,0.17947547065212724
5,23,0,1,38,39,0.5822106010953233,0.39819898016096017
5,24,0,1,37,38,0.46927516877390574,0.3209575594622967
5,25,0,1,12,13,0.22805126130346445,0.1559741088613263
5,26,0,1,31,32,1.695711600887054,1.1597704144342451
5,27,0,2,18,20,0.8593941214837193,0.5877767634037164
5,28,0,0,13,13,1.0548930199919149,0.7214869051670211
5,29,0,1,14,15,0.07619791630339764,0.05211504652323458
5,30,0,3,16,19,1.2520157358347288,0.8563076457504027
5,31,0,0,15,15,0.6438269328176326,0.4403410511004516
5,32,0,1,11,12,0.4792121678030752,0.3277539023523635
5,33,0,2,12,14,0.7176331921972283,0.49082034013977704
5,34,0,1,42,43,1.0535058474526804,0.7205381579449828
5,35,0,1,40,41,0.2947489253794587,0.20159152249861392
5,36,0,2,19,21,1.1778923034045035,0.8056114283606527
5,37,0,0,16,16,1.6407849267208845,1.1222036892742182
5,38,0,1,7,8,1.1523355540296987,0.7881320634742507
5,39,0,1,36,37,0.2912086075587787,0.1991701462079929
5,40,0,1,13,14,0.17590141356618952,0.12030657524812047
5,41,0,1,16,17,0.3042237928763444,0.20807179367080164
5,42,0,1,17,18,0.23072157342659672,0.15780045067327936
5,43,0,1,21,22,1.444079963511401,0.9876686677626616
5,44,0,2,31,33,0.29392754811122046,0.20102974710337976
5,45,0,1,39,40,1.3007185023858852,0.8896175716349584
5,46,0,1,19,20,0.8845021407325786,0.6049492223729418
5,47,0,0,12,12,1.2380294882953673,0.8467418468865984
5,48,0,1,41,42,0.8549268974596599,0.5847214359205266
5,49,0,2,11,13,0.8998910979975113,0.6154743950116887
5,50,0,3,17,20,1.0336971305974136,0.7069901207996182
5,51,0,2,17,19,1.6608427861572503,1.1359221257931456
5,52,0,1,15,16,0.18733967504550084,0.12812969637869986
5,53,0,0,17,17,3.0071548014693223,2.0567230704464023
5,54,0,2,10,12,1.7544586059522749,1.1999500289250704
5,55,0,1,2,3,0.4046067489156384,0.2767280336038922
5,56,0,2,16,18,0.5631727895828834,0.3851781984807774
5,57,0,1,18,19,0.5376443738339673,0.36771821218506423
5,58,0,1,3,4,0.5297739431483982,0.36233528465587606
5,59,0,1,28,29,0.40834184749210467,0.27928262886744704
5,60,0,1,27,28,0.22664667078716655,0.15501344873236036
5,61,0,1,26,27,0.17669211988538663,0.12084737345639557
5,62,0,1,25,26,0.26292573827538496,0.17982627015440447
5,63,0,1,24,25,0.5407224976966523,0.3698234740621655
5,64,0,1,23,24,0.7813201499117779,0.5343786016413324
5,65,0,2,15,17,0.9956508181376457,0.6809686042008775
5,66,0,2,14,16,1.1983135803545935,0.8195784218159625
5,67,0,2,13,15,1.4924360794985119,1.0207415043520116
5,68,0,1,22,23,1.4574192070320577,0.996791952629085
5,69,0,1,20,21,1.053084216947863,0.7202497866293331
5,70,0,0,5,5,0.12562092149728105,0.08591757472809639
5,71,0,0,4,4,1.5919701696470063,1.088817168233457
5,72,0,0,6,6,0.7799487620180295,0.5334406502202
5,73,0,0,14,14,5.2068331172711035,3.56117809133847
6,0,1,0,0,1,0.0006047273064730442,0.00041359912763530224
6,1,0,0,2,2,0.6096508757880754,0.41696656937598636
6,2,0,1,3,4,2.8264080841554025,1.9331025826599557
6,3,0,1,4,5,2.916676505296275,1.994841055252883
6,4,0,1,5,6,2.9545570132120895,2.0207491709616643
6,5,0,0,1,1,0.09185547306066996,0.06282392595763255
6,7,0,0,1,1,0.18606455429627888,0.12725758621621397
6,8,0,0,6,6,2.218200447015665,1.5171231065399418
6,9,0,0,7,7,4.375,2.992251489283634
6,10,0,0,8,8,4.327160493827161,2.959531984462543
6,11,0,0,10,10,0.07667753539804649,0.052443078740435
6,12,0,0,9,9,0.0009159718866713741,0.0006264727410364249
6,13,0,1,29,30,0.0503002605674357,0.03440252105011756
6,14,0,1,10,11,0.34263143907238575,0.2343404420205122
6,15,0,2,3,5,6.783415232920819,4.639470704716939
6,16,0,1,9,10,0.02131522251484179,0.01457840144330226
6,17,0,1,28,29,0.3287572868168918,0.22485130996358657
6,18,0,1,33,34,0.460607168171626,0.31502913941400346
6,19,0,1,34,35,0.9556871479210971,0.6536357238071158
6,20,0,1,31,32,0.30814033307595473,0.21075048469825847
6,21,0,1,32,33,0.3171441302284725,0.21690857051284787
6,22,0,2,29,31,0.17467430008765203,0.11946729933185216
6,23,0,1,37,38,0.48328506404088256,0.3305395320285411
6,24,0,1,36,37,0.3732380482011447,0.2552736241342153
6,25,0,1,11,12,0.3218353032688902,0.2201170664023741
6,26,0,1,30,31,1.4607511318455229,0.9990707999400045
6,27,0,2,17,19,0.9701458359088054,0.6635246451018146
6,28,0,0,12,12,1.1887540469512279,0.8130402439729733
6,29,0,1,13,14,0.16675779821437473,0.11405286172722798
6,30,0,3,15,18,1.4546814394491248,0.9949194751142637
6,31,0,0,14,14,0.6650560530578108,0.45486056347870396
6,32,0,1,10,11,0.6140671363050362,0.4199870407151727
6,33,0,2,11,13,0.8761524297317619,0.5992384943324203
6,34,0,1,41,42,0.9168805825418909,0.6270942373957071
6,35,0,1,39,40,0.3516824641001532,0.24053082901911346
6,36,0,2,18,20,1.396580257719699,0.9551815671007752
6,37,0,0,15,15,1.6906727432728306,1.1563241220455713
6,38,0,1,6,7,1.3348268384380577,0.9129457360576096
6,39,0,1,35,36,0.22053678896565687,0.15083463662270108
6,40,0,1,12,13,0.3088935347099161,0.21126563183219024
6,41,0,1,15,16,0.14174494668129384,0.0969454920698356
6,42,0,1,16,17,0.16552945357246848,0.11321274376514856
6,43,0,1,20,21,1.2609493016332727,0.8624176973081868
6,44,0,2,30,32,0.2128646486759914,0.14558732846093092
6,45,0,1,38,39,1.128431557788174,0.7717830878505861
6,46,0,1,18,19,0.6980033918814816,0.4773946717445466
6,47,0,0,11,11,1.3929525621060388,0.9527004293630281
6,48,0,1,40,41,0.6860029154456998,0.46918702751892805
6,49,0,2,10,12,1.06561933116157,0.7288230927263173
6,50,0,3,16,19,1.2174244781354076,0.8326491903522341
6,51,0,2,16,18,1.8807377772504228,1.2863178091267586
6,52,0,1,14,15,0.09912710745276825,0.06779731083518277
6,53,0,0,16,16,2.9052958541257037,1.9870573363010753
6,54,0,2,9,11,1.996262968664578,1.3653304779401947
6,55,0,1,1,2,0.2960546621112952,0.20248457225414537
6,56,0,2,15,17,0.6584105264775114,0.45031540077996685
6,57,0,1,17,18,0.41163630117428224,0.28153584805301773
6,58,0,1,2,3,0.4119064822424851,0.281720636556722
6,59,0,1,27,28,0.22637274337103072,0.15482609793947166
6,60,0,1,26,27,0.15285620939939967,0.10454496462208107
6,61,0,1,25,26,0.2888448056438769,0.1975534399679388
6,62,0,1,24,25,0.43319326239900197,0.2962795850425256
6,63,0,1,23,24,0.7520466600486343,0.5143571973808706
6,64,0,1,22,23,0.9970685069049843,0.6819382227895425
6,65,0,2,14,16,1.2131301125442953,0.8297120882183977
6,66,0,2,13,15,1.4167145365686766,0.968952270157119
6,67,0,2,12,14,1.6971815893481232,1.1607758030426714
6,68,0,1,21,22,1.2758279971403659,0.8725938798886893
6,69,0,1,19,20,0.8341437518727005,0.5705069448726232
6,70,0,0,4,4,0.14541587098593528,0.09945619577671809
6,71,0,0,3,3,1.8128092298668128,1.2398585412242487
6,72,0,0,5,5,0.608057891251034,0.4158770584380738
6,73,0,0,13,13,5.862359814213986,4.009521116525332
7,0,1,0,0,1,0.0006961067226298661,0.000476097457711901
7,1,0,0,1,1,0.16087851094543054,0.11003176319318811
7,2,0,1,2,3,3.8923998288291424,2.6621803850745973
7,3,0,1,3,4,4.079573590966814,2.7901966064486015
7,4,0,1,4,5,4.223172841977984,2.888410337351045
7,5,0,0,2,2,0.37662337662337664,0.2575889964800754
7,6,0,0,1,1,0.4983871990078899,0.340868534507716
7,8,0,0,5,5,0.8229281522719056,0.5628361118192089
7,9,0,0,6,6,2.243098554799412,1.5341519979905163
7,10,0,0,7,7,2.432130099440944,1.6634388370705637
7,11,0,0,9,9,0.06305546035431334,0.043126353177750675
7,12,0,0,8,8,0.0026099000200172882,0.0017850233649778552
7,13,0,1,28,29,0.07107115438249734,0.048608632581973656
7,14,0,1,9,10,0.30395250563084564,0.2078862486046606
7,15,0,2,2,4,9.341681534332505,6.389179539090254
7,16,0,1,8,9,0.030652394343307562,0.02096449659974201
7,17,0,1,27,28,0.1965472449954619,0.13442715121194654
7,18,0,1,32,33,0.18035324541952036,0.12335137536084491
7,19,0,1,33,34,0.5111003811705588,0.3495636289670943
7,20,0,1,30,31,0.18026382467598992,0.12329021665158738
7,21,0,1,31,32,0.1097847012762731,0.0750864996330256
7,22,0,2,28,30,0.260495728739183,0.1781642816621362
7,23,0,1,36,37,0.2113993144238857,0.14458512306706542
7,24,0,1,35,36,0.16242653253770528,0.11109052203088575
7,25,0,1,10,11,0.6171395022647511,0.42208836451370557
7,26,0,1,29,30,0.7459359299702711,0.5101778051117065
7,27,0,2,16,18,1.3203806277533237,0.9030653485294039
7,28,0,0,11,11,1.6811586444852145,1.1498170188989572
7,29,0,1,12,13,0.5934214182112377,0.40586654226637303
7,30,0,3,14,17,2.089459742107727,1.4290717771702957
7,31,0,0,13,13,0.745989714438074,0.5102145906325943
7,32,0,1,9,10,1.0355378862994604,0.7082490931403855
7,33,0,2,10,12,1.3702132648821879,0.9371480417096952
7,34,0,1,40,41,0.5196880988076191,0.3554371400274466
7,35,0,1,38,39,0.6962268791737004,0.4761796379626975
7,36,0,2,17,19,2.1078806577298064,1.4416706371026695
7,37,0,0,14,14,1.8891534003702066,1.2920736173126839
7,38,0,1,5,6,1.9025333266423774,1.3012247268702628
7,39,0,1,34,35,0.14625095819907194,0.10002734799550436
7,40,0,1,11,12,0.7416004215875424,0.5072125636454159
7,41,0,1,14,15,0.4551285678053116,0.31128208796136475
7,42,0,1,15,16,0.05539755309477928,0.03788877960011942
7,43,0,1,19,20,0.6958455002509384,0.47591879644278523
7,44,0,2,29,31,0.2813986172734774,0.19246067008432416
7,45,0,1,37,38,0.6178106918955096,0.4225474200959293
7,46,0,1,17,18,0.14880386648041943,0.10177339224850242
7,47,0,0,10,10,1.942723692968772,1.3287126545262649
7,48,0,1,39,40,0.41891765300593387,0.2865158791072481
7,49,0,2,9,11,1.581549257369686,1.081689856169113
7,50,0,3,15,18,1.793896563844267,1.226923351950583
7,51,0,2,15,17,2.5707368625607963,1.7582379898408864
7,52,0,1,13,14,0.6288490943238709,0.4300970603486325
7,53,0,0,15,15,2.67504990607652,1.82958218636926
7,54,0,2,8,10,2.747942547599168,1.8794366126901652
7,55,0,1,0,1,0.04058499018272314,0.027757827958129134
7,56,0,2,14,16,0.9569657008256404,0.6545101813688866
7,57,0,1,16,17,0.06914762338544513,0.047293046641262174
7,58,0,1,1,2,0.0465657314657332,0.03184831527495359
7,59,0,1,26,27,0.5661112114231439,0.3871879121099576
7,60,0,1,25,26,0.6456607054653638,0.44159524742872147
7,61,0,1,24,25,0.9342044542670779,0.6389427816173872
7,62,0,1,23,24,1.0176249839258842,0.6959976854135911
7,63,0,1,22,23,1.428337732001141,0.9769018756069536
7,64,0,1,21,22,1.6767092872054536,1.146773911253993
7,65,0,2,13,15,1.8943858592697056,1.295652321983459
7,66,0,2,12,14,2.0989384198765033,1.435554654352024
7,67,0,2,11,13,2.3349743113623807,1.5969897967115683
7,68,0,1,20,21,0.7165463812477451,0.4900770231838546
7,69,0,1,18,19,0.20225234446561238,0.13832911518590518
7,70,0,0,3,3,0.20696865516185434,0.14155480380413477
7,71,0,0,2,2,2.498056084161712,1.7085284658621545
7,72,0,0,4,4,0.07906456622733124,0.05407567223846776
7,73,0,0,12,12,8.336101039811348,5.701419600272997
8,0,1,0,0,1,0.0007922604894034031,0.0005418611724155232
8,1,0,0,4,4,0.10381146477237856,0.07100114515882634
8,2,0,1,3,4,4.520834666751809,3.0919941175755845
8,3,0,1,2,3,4.765151515151516,3.259092964085551
8,4,0,1,3,4,4.971074380165289,3.399932506831841
8,5,0,0,7,7,0.5445395440277321,0.37243411693504286
8,6,0,0,6,6,0.7922144453627374,0.5418296809071221
8,7,0,0,5,5,0.10972375363625408,0.07504481490922785
8,9,0,0,1,1,0.9862089153375962,0.6745108790088503
8,10,0,0,2,2,1.3148727744716564,0.8992982897443013
8,11,0,0,4,4,0.05740188240622322,0.03925962699833268
8,12,0,0,3,3,0.0037795082348359914,0.0025849689473023433
8,13,0,1,23,24,0.11933892929531198,0.08162104889449406
8,14,0,1,4,5,0.28851300343425296,0.1973265061037343
8,15,0,2,3,5,10.850115206761632,7.4208624883043415
8,16,0,1,3,4,0.03616382589539434,0.024734002718557198
8,17,0,1,22,23,0.12242647340467716,0.08373275368523164
8,18,0,1,27,28,0.12455409704012417,0.08518792739764339
8,19,0,1,28,29,0.2764144690092868,0.1890517957834476
8,20,0,1,25,26,0.35841825962696044,0.2451377305497647
8,21,0,1,26,27,0.17701092425974274,0.12106541753958576
8,22,0,2,23,25,0.44432498394533776,0.3038930502711688
8,23,0,1,31,32,0.16569050067486937,0.11332289083532088
8,24,0,1,30,31,0.23221691622393828,0.15882318020752736
8,25,0,1,5,6,0.7914978936599008,0.5413396002442736
8,26,0,1,24,25,0.35533363243443333,0.24302802076445634
8,27,0,2,11,13,1.5275754749728667,1.044774854852735
8,28,0,0,6,6,1.992047024261243,1.3624470114442822
8,29,0,1,7,8,0.8500300114749851,0.5813722440621276
8,30,0,3,9,12,2.4638964244216477,1.685165198952296
8,31,0,0,8,8,0.7989126285892728,0.5464108577608582
8,32,0,1,4,5,1.2840723938864338,0.8782325789610702
8,33,0,2,5,7,1.6614077628392365,1.136308537751565
8,34,0,1,35,36,0.33415599040197086,0.22854371655619313
8,35,0,1,33,34,0.9294645345507564,0.6357009457704732
8,36,0,2,12,14,2.532945881410138,1.7323911053541332
8,37,0,0,9,9,2.0219682152278335,1.3829114064684929
8,38,0,1,4,5,2.237026306081694,1.5299989247861976
8,39,0,1,29,30,0.25141372670592793,0.1719527081513512
8,40,0,1,6,7,0.9980714107809799,0.6826241520733267
8,41,0,1,9,10,0.7782225788761412,0.532260039002579
8,42,0,1,10,11,0.16656797077736432,0.11392303054297626
8,43,0,1,14,15,0.3651577632255622,0.24974716819089576
8,44,0,2,24,26,0.4573375529814896,0.31279290834610174
8,45,0,1,32,33,0.36357160398536326,0.24866232536832977
8,46,0,1,12,13,0.2507592923130847,0.1715051122001229
8,47,0,0,5,5,2.2848468599910827,1.5627054673356233
8,48,0,1,34,35,0.5884827949906437,0.4024888045093826
8,49,0,2,4,6,1.88557073650041,1.2896232787298263
8,50,0,3,10,13,2.134109196251292,1.459609467606132
8,51,0,2,10,12,2.977891157144877,2.036708399975159
8,52,0,1,8,9,0.9734360085397978,0.6657749362915489
8,53,0,0,10,10,2.5881653733871026,1.7701581012639749
8,54,0,2,3,5,3.1908056017739765,2.1823297860394844
8,55,0,1,5,6,0.23905772064104458,0.16350190185438093
8,56,0,2,9,11,1.1331170497199365,0.7749876981844931
8,57,0,1,11,12,0.22805382480578354,0.15597586215129938
8,58,0,1,6,7,0.1690518108132209,0.11562183603930411
8,59,0,1,21,22,0.9567251762229722,0.6543456762030482
8,60,0,1,20,21,0.9913509176097548,0.6780277164846825
8,61,0,1,19,20,1.3319909221332584,0.9110061303921198
8,62,0,1,18,19,1.3672446974642618,0.9351177102177346
8,63,0,1,17,18,1.8291058985400437,1.25100453690604
8,64,0,1,16,17,2.0781825410170938,1.4213588121969478
8,65,0,2,8,10,2.2962892318452104,1.5705313997290977
8,66,0,2,7,9,2.5011447076355187,1.7106409088768595
8,67,0,2,6,8,2.7107569284242365,1.8540037614087659
8,68,0,1,15,16,0.3907190630692016,0.2672296453395028
8,69,0,1,13,14,0.30252741959133533,0.20691157070201324
8,70,0,0,2,2,0.243235462817086,0.16635924019680445
8,71,0,0,3,3,2.9019307999443775,1.9847558303843682
8,72,0,0,1,1,0.2403432493491674,0.1643811304695575
8,73,0,0,7,7,9.91382031010748,6.780489962836445
9,0,1,0,0,1,0.0008870078218015784,0.0006066629658953156
9,1,0,0,5,5,0.31140694065044644,0.2129846587278991
9,2,0,1,4,5,5.013899709514332,3.429222599522981
9,3,0,1,3,4,5.303035714282953,3.6269752031514204
9,4,0,1,4,5,5.55785738424804,3.8012587509125115
9,5,0,0,8,8,0.6762548640807632,0.46251991409850635
9,6,0,0,7,7,1.0227272727272727,0.6994873611312391
9,7,0,0,6,6,0.1957613284188578,0.13388962891553596
9,8,0,0,1,1,0.6455185627664266,0.44149802989670195
9,10,0,0,1,1,0.4382716049382716,0.2997528828770907
9,11,0,0,3,3,0.055256281327723734,0.03779215773603584
9,12,0,0,2,2,0.004720824269233181,0.0032287756457735563
9,13,0,1,22,23,0.16010245090122918,0.10950098220506581
9,14,0,1,3,4,0.2831191422747597,0.19363741145516683
9,15,0,2,4,6,12.033379501296475,8.230148053455892
9,16,0,1,2,3,0.04051169753997558,0.027707699953691437
9,17,0,1,21,22,0.07666232819172342,0.052432677875116594
9,18,0,1,26,27,0.22399886673084846,0.15320250115959486
9,19,0,1,27,28,0.1994597846516851,0.13641916289741662
9,20,0,1,24,25,0.5248540052918562,0.3589703266265228
9,21,0,1,25,26,0.2916736991680762,0.19948824245040972
9,22,0,2,22,24,0.597643520652385,0.40875422051035737
9,23,0,1,30,31,0.2557350007820596,0.17490821416047295
9,24,0,1,29,30,0.35637333391402903,0.24373911751890903
9,25,0,1,4,5,0.928725876682166,0.6351957457459336
9,26,0,1,23,24,0.2385756479224114,0.16317219149774703
9,27,0,2,10,12,1.691617642357127,1.1569703793466477
9,28,0,0,5,5,2.2467083062723305,1.5366208629552665
9,29,0,1,6,7,1.0525246615948274,0.7198670825519714
9,30,0,3,8,11,2.7590200869652577,1.8870130203852007
9,31,0,0,7,7,0.8448477364313375,0.5778278622981889
9,32,0,1,3,4,1.4795651878080267,1.011938545533894
9,33,0,2,4,6,1.8903624899453277,1.2929005659028172
9,34,0,1,34,35,0.29387013767099707,0.2009904816233206
9,35,0,1,32,33,1.1197718021493883,0.7658603068889889
9,36,0,2,11,13,2.8711029322234936,1.9636713199616818
9,37,0,0,8,8,2.1389142539982267,1.4628958541659853
9,38,0,1,5,6,2.4999327837328833,1.7098120217677029
9,39,0,1,28,29,0.35734102415494773,0.24440096267652148
9,40,0,1,5,6,1.2001211035662762,0.8208146650210075
9,41,0,1,8,9,1.0346122185457338,0.7076159889770324
9,42,0,1,9,10,0.26023066690918656,0.1779829944265798
9,43,0,1,13,14,0.13097188674138463,0.0895773310071304
9,44,0,2,23,25,0.609326856791654,0.41674495878750684
9,45,0,1,31,32,0.29679946676061897,0.2029939763275544
9,46,0,1,11,12,0.5111040306232925,0.34956612498546624
9,47,0,0,4,4,2.563659121310354,1.753397216858624
9,48,0,1,33,34,0.8198780397107854,0.5607500080812672
9,49,0,2,3,5,2.1245637835812974,1.4530809475426765
9,50,0,3,9,12,2.4023424872567545,1.643065802345914
9,51,0,2,9,11,3.299243120063942,2.2564948890331684
9,52,0,1,7,8,1.2458763342469776,0.8521086437974293
9,53,0,0,9,9,2.564360349092927,1.7538768168304482
9,54,0,2,2,4,3.5388032050113405,2.420340379537573
9,55,0,1,6,7,0.3947383650068089,0.269978619558631
9,56,0,2,8,10,1.2719801441533347,0.8699621670130346
9,57,0,1,10,11,0.40657401861177117,0.27807353433030957
9,58,0,1,7,8,0.3380973339975278,0.2312393716975837
9,59,0,1,20,21,1.270607005955887,0.8690230184835935
9,60,0,1,19,20,1.2667713389732738,0.866399640142766
9,61,0,1,18,19,1.6473834313728346,1.1267166916449252
9,62,0,1,17,18,1.6436135819253421,1.124138328759523
9,63,0,1,16,17,2.1452890311341712,1.4672558396240156
9,64,0,1,15,16,2.3945691586746918,1.6377492871398869
9,65,0,2,7,9,2.612802115196637,1.7870082332344153
9,66,0,2,6,8,2.817746842004264,1.9271787850083464
9,67,0,2,5,7,3.0063662197447303,2.056183725340155
9,68,0,1,14,15,0.16386091689754817,0.11207155945647322
9,69,0,1,12,13,0.6025504162685544,0.41211025838812704
9,70,0,0,3,3,0.27173459256592886,0.18585102612463594
9,71,0,0,4,4,3.2189241395830233,2.2015612686990496
9,72,0,0,2,2,0.48663476259738153,0.3328305355701035
9,73,0,0,6,6,11.210804676027703,7.667553597236988
10,0,1,0,0,1,0.0009373968553101652,0.0006411262025946599
10,1,0,0,6,6,0.4152072522776657,0.28397817576896245
10,2,0,1,5,6,5.260426980187909,3.597833249310876
10,3,0,1,4,5,5.571974847040448,3.8109142935560523
10,4,0,1,5,6,5.851245505903612,4.001919560960972
10,5,0,0,9,9,0.7421173469351519,0.5075661112205548
10,6,0,0,8,8,1.1379870129870129,0.7783184764333311
10,7,0,0,7,7,0.2387909552178381,0.16331944945783716
10,8,0,0,2,2,0.9682244975654924,0.6622105588117128
10,9,0,0,1,1,0.4930555555555556,0.337221993236727
10,11,0,0,2,2,0.054836432107354394,0.03750500471776733
10,12,0,0,1,1,0.005192532395900251,0.0035513972102368093
10,13,0,1,21,22,0.18067927581384863,0.12357436163124048
10,14,0,1,2,3,0.282057020054715,0.19291098018779995
10,15,0,2,5,7,12.625044004323751,8.634812965533522
10,16,0,1,1,2,0.042684078716859856,0.02919348528210829
10,17,0,1,20,21,0.06540749914098193,0.04473501410626769
10,18,0,1,25,26,0.2875791458468565,0.19668780055935353
10,19,0,1,26,27,0.23578503384543148,0.16126356998280783
10,20,0,1,23,24,0.6096515804417568,0.41696705131907835
10,21,0,1,24,25,0.35236555068060815,0.24099802143915366
10,22,0,2,21,23,0.6748616684958025,0.46156704745531496
10,23,0,1,29,30,0.31694409448320343,0.21677175742560414
10,24,0,1,28,29,0.4238162640749461,0.2898662508253448
10,25,0,1,3,4,0.9973045242937533,0.6820996452770947
10,26,0,1,22,23,0.3281961844907659,0.22446754784450293
10,27,0,2,9,11,1.7735849078416588,1.2130313329966127
10,28,0,0,4,4,2.374860876216358,1.6242699414171045
10,29,0,1,5,6,1.1537313024995668,0.7890866761457086
10,30,0,3,7,10,2.906477738986181,1.9878656784116864
10,31,0,0,6,6,0.8682948915978993,0.5938643845762711
10,32,0,1,2,3,1.577261895359481,1.0787575440867965
10,33,0,2,3,5,2.0047842101953246,1.371158523119834
10,34,0,1,33,34,0.3226366605299658,0.2206651492498945
10,35,0,1,31,32,1.2154301491780037,0.8312851826281397
10,36,0,2,10,12,3.0401983706931532,2.079322994839832
10,37,0,0,7,7,2.198882179736675,1.5039105090460136
10,38,0,1,6,7,2.6313250924415406,1.7996768975194501
10,39,0,1,27,28,0.4120960708904964,0.2818503044228622
10,40,0,1,4,5,1.3010962758621456,0.8898759472342617
10,41,0,1,7,8,1.162813478996317,0.7952983689796143
10,42,0,1,8,9,0.30722051436133696,0.21012138094541588
10,43,0,1,12,13,0.10285699316295419,0.07034834079430541
10,44,0,2,22,24,0.6863911951195196,0.4694525887605842
10,45,0,1,30,31,0.3364827830146829,0.23013511053576835
10,46,0,1,10,11,0.6436524538949251,0.44022171742814975
10,47,0,0,3,3,2.7037734048917637,1.849227427993797
10,48,0,1,32,33,0.9455178475311822,0.6466804999815853
10,49,0,2,2,4,2.2440035489739802,1.534770962600035
10,50,0,3,8,11,2.536366719387359,1.7347307642185759
10,51,0,2,8,10,3.459794158593067,2.3663026796948397
10,52,0,1,6,7,1.3820622829113576,0.9452520969883998
10,53,0,0,8,8,2.5621998360783644,1.7523991486509187
10,54,0,2,1,3,3.7127272673891105,2.5392945588912053
10,55,0,1,7,8,0.47258899132812077,0.3232240258561417
10,56,0,2,7,9,1.3413631477696637,0.9174162003620479
10,57,0,1,9,10,0.4966306593780931,0.3396671611766885
10,58,0,1,8,9,0.4226207243427503,0.28904856955810804
10,59,0,1,19,20,1.4277934544593411,0.9765296206846602
10,60,0,1,18,19,1.4045589876210367,0.9606385651418881
10,61,0,1,17,18,1.8050763920815096,1.2345697194232288
10,62,0,1,16,17,1.781748919299737,1.21861505309809
10,63,0,1,15,16,2.3032967201926025,1.5753241237162112
10,64,0,1,14,15,2.552667875233674,1.7458798288718747
10,65,0,2,6,8,2.770960601713781,1.8951796542227055
10,66,0,2,5,7,2.9759495810246888,2.03538047219523
10,67,0,2,4,6,3.15408203871498,2.157212954895465
10,68,0,1,13,14,0.12089105181953955,0.0826826125367045
10,69,0,1,11,12,0.7573315655164196,0.51797177252526
10,70,0,0,4,4,0.28597807784091706,0.19559276098787542
10,71,0,0,5,5,3.3773981110668245,2.3099484634842145
10,72,0,0,3,3,0.6097928094422981,0.4170636439332955
10,73,0,0,5,5,11.86410622559083,8.114374748009919
11,0,1,0,0,1,0.0007475997921439725,0.0005113157923270713
11,1,0,0,8,8,1.1718399423925203,0.8014719572173866
11,2,0,1,7,8,5.926387627594064,4.053312503940672
11,3,0,1,6,7,6.316957678810753,4.320440233637294
11,4,0,1,7,8,6.6882447105022225,4.574379473301409
11,5,0,0,11,11,1.029235306212229,0.7039384863627063
11,6,0,0,10,10,1.6829225301649164,1.1510234165108462
11,7,0,0,9,9,0.5166726206001917,0.35337472422011457
11,8,0,0,4,4,3.527606591509718,2.4126825318975356
11,9,0,0,3,3,5.18795085799184,3.5482636985500324
11,10,0,0,2,2,4.576472605502663,3.130047307309965
11,12,0,0,1,1,0.006735204630265363,0.0046064973909809275
11,13,0,1,21,22,0.25843377737875023,0.1767540240554881
11,14,0,1,0,1,0.08279613531514657,0.056627853532268936
11,15,0,2,7,9,14.248650033521695,9.745267264705507
11,16,0,1,1,2,0.047252191751987783,0.03231781511812601
11,17,0,1,20,21,0.2660747992356009,0.18198004897681613
11,18,0,1,25,26,0.6934334238224719,0.47426907317756356
11,19,0,1,26,27,0.9386164915841005,0.6419603645277039
11,20,0,1,23,24,0.9912288709436826,0.6779442434976387
11,21,0,1,24,25,0.6689426580998307,0.45751878055875905
11,22,0,2,21,23,0.9773837589942238,0.6684749733604806
11,23,0,1,29,30,0.6815660900231499,0.4661524909524557
11,24,0,1,28,29,0.741374737724527,0.5070582087025095
11,25,0,1,3,4,1.2188744972515761,0.8336409210630558
11,26,0,1,22,23,1.5704224701448737,1.0740797657361099
11,27,0,2,9,11,1.89206218605872,1.294063061497475
11,28,0,0,2,2,2.3804059952251024,1.6280624878427437
11,29,0,1,5,6,1.5419309389230644,1.0545931767691545
11,30,0,3,7,10,3.2302961734267583,2.2093390938887865
11,31,0,0,4,4,0.7122077786540786,0.48710966545304124
11,32,0,1,2,3,1.8692759262264622,1.278478554087583
11,33,0,2,3,5,2.3270677980971435,1.591582190747466
11,34,0,1,33,34,0.7919834253754899,0.5416716763583459
11,35,0,1,31,32,1.425891804546055,0.9752290001623454
11,36,0,2,10,12,3.321695183967079,2.2718508254106897
11,37,0,0,5,5,1.765920396796628,1.2077892428048127
11,38,0,1,8,9,2.9636781544253132,2.026987513448346
11,39,0,1,27,28,0.6314741152965391,0.43189242558631635
11,40,0,1,4,5,1.6573123665018805,1.1335075192853568
11,41,0,1,7,8,1.7373934562568578,1.1882784358757081
11,42,0,1,8,9,0.5611195158886484,0.3837738759048959
11,43,0,1,12,13,1.2806141359354701,0.8758673269601336
11,44,0,2,22,24,0.9573661765186232,0.6547840839948865
11,45,0,1,30,31,1.0488711740704473,0.7173683046123358
11,46,0,1,10,11,1.4739911103491872,1.0081261931733012
11,47,0,0,1,1,2.710692081830764,1.8539594100222758
11,48,0,1,32,33,1.3997085410898942,0.9573211352318305
11,49,0,2,2,4,2.5621418921507524,1.7523595182957887
11,50,0,3,8,11,2.840976009312869,1.9430662159738301
11,51,0,2,8,10,3.7475784192281365,2.563130767118308
11,52,0,1,6,7,1.9497619715139922,1.3335264372597344
11,53,0,0,6,6,1.0829589096544707,0.7406823794849304
11,54,0,2,1,3,4.133597142490917,2.827145647021033
11,55,0,1,9,10,0.9543814549767667,0.6527427039997512
11,56,0,2,7,9,1.4960218939282435,1.023193997738905
11,57,0,1,9,10,1.0276934592347302,0.702883950610782
11,58,0,1,10,11,0.9897726725418609,0.6769482865064288
11,59,0,1,19,20,2.0881896258683463,1.4282030898082727
11,60,0,1,18,19,1.9404048678111974,1.3271267098334327
11,61,0,1,17,18,2.370843612301821,1.6215223610899918
11,62,0,1,16,17,2.236635145409649,1.5297313931054033
11,63,0,1,15,16,2.778730980603156,1.9004941520064838
11,64,0,1,14,15,2.993170405581595,2.0471585380071375
11,65,0,2,6,8,3.1850613733254005,2.1784010600669044
11,66,0,2,5,7,3.3681852317562515,2.303647377349894
11,67,0,2,4,6,3.4862029647040216,2.384364802989858
11,68,0,1,13,14,1.244217811640216,0.850974308542551
11,69,0,1,11,12,1.706421753054757,1.1670955501540767
11,70,0,0,6,6,0.3223913046146711,0.22049733974064986
11,71,0,0,7,7,3.7942784751521006,2.5950709526927334
11,72,0,0,5,5,1.4217138865443006,0.9723715415651216
11,73,0,0,3,3,11.87497748839405,8.121810074252965
12,0,1,0,0,1,0.0004868254605198259,0.0003329609621169463
12,1,0,0,7,7,0.7194557189864901,0.49206684493964625
12,2,0,1,6,7,2.650461193999086,1.81276490400737
12,3,0,1,5,6,2.7275357617264677,1.8654795303086615
12,4,0,1,6,7,2.751659687557931,1.8819789252793047
12,5,0,0,10,10,0.1205829879650781,0.0824719143590344
12,6,0,0,9,9,0.22070758960204337,0.15095145455609493
12,7,0,0,8,8,0.2347771152552279,0.1605742109193534
12,8,0,0,3,3,2.54993112854653,1.744008049591783
12,9,0,0,2,2,4.865989615512102,3.3280604968810934
12,10,0,0,1,1,4.757513570732607,3.25386904395697
12,11,0,0,1,1,0.07394178645421799,0.050571981860097426
12,13,0,1,20,21,0.05005665724197294,0.03423591021276661
12,14,0,1,1,2,0.32636501057787237,0.22321512890324743
12,15,0,2,6,8,6.37046134732625,4.357033703762468
12,16,0,1,0,1,0.019139784946236558,0.013090525716558816
12,17,0,1,19,20,0.3492581081151641,0.23887270723473925
12,18,0,1,24,25,0.5060968958136868,0.34614152919321794
12,19,0,1,25,26,1.025848212279615,0.70162190650803
12,20,0,1,22,23,0.3469926538764633,0.2373232652188178
12,21,0,1,23,24,0.35328990033073177,0.24163022409451393
12,22,0,2,20,22,0.1834174891024353,0.1254471439834118
12,23,0,1,28,29,0.5197540901581355,0.35548227436272933
12,24,0,1,27,28,0.40130132286862846,0.2744673099440333
12,25,0,1,2,3,0.26931240696183384,0.1841943887575103
12,26,0,1,21,22,1.5873435599739043,1.0856528300198172
12,27,0,2,8,10,0.8758591983367839,0.5990379407145169
12,28,0,0,3,3,0.9548708322329122,0.6530774102451279
12,29,0,1,4,5,0.1200850039066715,0.08213132154979857
12,30,0,3,6,9,1.3128719711000003,0.8979298538886207
12,31,0,0,5,5,0.6057705094556788,0.4143126192189396
12,32,0,1,1,2,0.5367890712029659,0.36713323376874357
12,33,0,2,2,4,0.7846902661150398,0.5366835696935083
12,34,0,1,32,33,0.9625214367402092,0.6583099891550431
12,35,0,1,30,31,0.1691025695024936,0.11565655209954874
12,36,0,2,9,11,1.1785979358350303,0.8060940408614826
12,37,0,0,6,6,1.5334861964474238,1.048817452597874
12,38,0,1,7,8,1.2274327765097688,0.8394942979444345
12,39,0,1,26,27,0.23115284886920112,0.15809541857851928
12,40,0,1,3,4,0.23830082368879538,0.16298422733264334
12,41,0,1,6,7,0.2560058884339058,0.17509348592725357
12,42,0,1,7,8,0.20747155092793912,0.14189875594242538
12,43,0,1,11,12,1.3748201029591784,0.9402988572746697
12,44,0,2,21,23,0.19570633584227087,0.13385201711686356
12,45,0,1,29,30,1.1988900585328832,0.81997270014454
12,46,0,1,9,10,0.816079123275043,0.5581517650269782
12,47,0,0,2,2,1.1465395550912705,0.7841679294273027
12,48,0,1,31,32,0.6902579228085687,0.47209721086028966
12,49,0,2,1,3,0.968891418584391,0.6626666949058918
12,50,0,3,7,10,1.0875434719998276,0.7438179597147836
12,51,0,2,7,9,1.7147346974516577,1.172781131925953
12,52,0,1,5,6,0.1639134025950772,0.11210745669226688
12,53,0,0,7,7,2.755580519600181,1.8846605516833395
12,54,0,2,0,2,1.8542407777783778,1.268195366582353
12,55,0,1,8,9,0.38615955269616753,0.2641111992357049
12,56,0,2,6,8,0.5913593512856131,0.40445620561969814
12,57,0,1,8,9,0.4918300300258616,0.33638380338726837
12,58,0,1,9,10,0.5043419749182088,0.34494126298451644
12,59,0,1,18,19,0.29864870251309494,0.20425874854112763
12,60,0,1,17,18,0.12568476986872007,0.08596124338741679
12,61,0,1,16,17,0.14048320515678184,0.09608253253707856
12,62,0,1,15,16,0.3021289308708132,0.20663902705231155
12,63,0,1,14,15,0.6065886717087684,0.41487219572643286
12,64,0,1,13,14,0.8541410653414054,0.5841839713888297
12,65,0,2,5,7,1.0716819826807538,0.7329696019919824
12,66,0,2,4,6,1.2762802602151282,0.8729032021421763
12,67,0,2,3,5,1.5673895716906008,1.0720054354694484
12,68,0,1,12,13,1.3844853116906648,0.9469093110394762
12,69,0,1,10,11,0.9637921397190287,0.659179077813514
12,70,0,0,5,5,0.13395057036105404,0.09161458140645855
12,71,0,0,6,6,1.6954781759777495,1.1596107650553875
12,72,0,0,4,4,0.7365306882053253,0.5037451539852535
12,73,0,0,4,4,4.643137668918901,3.1756424239477767
13,0,2,0,0,2,0.0005045920704532501,0.0003451123141244457
13,1,1,0,7,8,0.48954127685219206,0.3348184262232648
13,2,1,1,6,8,3.231616827328519,2.210242346141215
13,3,1,1,5,7,3.3609137903208373,2.298674124443755
13,4,1,1,6,8,3.441712194394199,2.353935643282671
13,5,1,0,10,11,0.2277417446667692,0.15576241706312988
13,6,1,0,9,10,0.2743650576405584,0.18765011481882304
13,7,1,0,8,9,0.14472671437890366,0.09898485180329179
13,8,1,0,3,4,1.822630920146583,1.2465760194795457
13,9,1,0,2,3,3.735723854362014,2.555022918118202
13,10,1,0,1,2,3.7474220168798236,2.5630237967960987
13,11,1,0,1,2,0.06422614585744088,0.0439270355640858
13,12,1,0,0,1,0.001133144476332155,0.0007750064564293516
13,14,1,1,1,3,0.2974067252156409,0.20340930661702167
13,15,1,2,6,9,7.7640553550033085,5.310172845460394
13,16,0,0,20,20,0.02430231809786882,0.01662140514774688
13,17,0,0,1,1,0.27418892742216705,0.18752965175407119
13,18,0,0,4,4,0.33666077208621675,0.2302568449504823
13,19,0,0,5,5,0.7712136095717018,0.5274663021249673
13,20,0,0,2,2,0.1405727826048374,0.09614379842333014
13,21,0,0,3,3,0.20143143558272075,0.13776766013964262
13,22,0,1,0,1,0.014824071182362593,0.010138822645181959
13,23,0,0,8,8,0.34458390014060597,0.2356758144866037
13,24,0,0,7,7,0.22627196409655154,0.15475717064023753
13,25,0,0,18,18,0.42965407147254064,0.2938589794835398
13,26,0,0,1,1,1.1870007243194123,0.8118410708858316
13,27,0,1,28,29,1.0699154693256512,0.7317614071993779
13,28,1,0,3,4,1.227126266911077,0.8392846627894254
13,29,0,0,16,16,0.32454049148333547,0.22196726147973783
13,30,0,2,26,28,1.6631903850565166,1.137527750090876
13,31,1,0,5,6,0.645734697439097,0.44164585373582965
13,32,0,0,19,19,0.7669109287999835,0.5245235128799189
13,33,0,1,22,23,1.0548954310487133,0.7214885541929172
13,34,0,0,12,12,0.7217421827122543,0.4936306562513288
13,35,0,0,10,10,0.37278150354157336,0.2549613735199235
13,36,0,1,29,30,1.577790276581927,1.0791189268296018
13,37,1,0,6,7,1.6289870925260883,1.1141346408308581
13,38,1,1,7,9,1.538453162897957,1.0522145755141779
13,39,0,0,6,6,0.09455265528875366,0.06466864539508461
13,40,0,0,17,17,0.4684877449854637,0.3204190063186023
13,41,0,0,14,14,0.169652677803524,0.11603279492995454
13,42,0,0,13,13,0.10427740780139184,0.07131982372396607
13,43,0,0,9,9,1.067479756974374,0.7300955183055318
13,44,0,1,1,2,0.026120300686358563,0.017864801972409767
13,45,0,0,9,9,0.898604714918339,0.6145945820552445
13,46,0,0,11,11,0.509219691954281,0.3482773443709144
13,47,1,0,2,3,1.4512102827372133,0.99254540109352
13,48,0,0,11,11,0.3661365865356807,0.25041662773545525
13,49,0,1,21,22,1.2513763692935547,0.8558703553538255
13,50,0,2,27,29,1.4060379520771686,0.9616500928210785
13,51,0,1,27,28,2.0958994301940166,1.4334761580312607
13,52,0,0,15,15,0.2848297010142757,0.1948073364690694
13,53,1,0,7,8,2.5750572809162904,1.7611929105856994
13,54,0,1,20,21,2.2660662453630307,1.549860593714949
13,55,1,1,8,10,0.22844152039298438,0.15624102391088573
13,56,0,1,26,27,0.7562186124218075,0.5172105758270072
13,57,0,0,12,12,0.2864516876582536,0.19591668320073594
13,58,1,1,9,11,0.3222762191835556,0.22041862784290128
13,59,0,0,2,2,0.15094633984550637,0.10323872233248686
13,60,0,0,3,3,0.25979499364056874,0.17768501865815406
13,61,0,0,4,4,0.48777812088780365,0.33361252769520067
13,62,0,0,5,5,0.6258081932792112,0.42801725676471314
13,63,0,0,6,6,0.980378386609539,0.6705231285471724
13,64,0,0,7,7,1.2289218542235572,0.8405127425174044
13,65,0,1,25,26,1.4468091568303905,0.989535280967985
13,66,0,1,24,25,1.6515639933237125,1.1295759585531666
13,67,0,1,23,24,1.917764631167119,1.3116420739897807
13,68,0,0,8,8,1.0783314486906586,0.7375174590368003
13,69,0,0,10,10,0.5982184501454195,0.4091474396261895
13,70,1,0,5,6,0.16765048124350146,0.11466340621256806
13,71,1,0,6,7,2.069552770210565,1.415456539157402
13,72,1,0,4,5,0.46666524574023094,0.3191725203572844
13,73,1,0,4,5,6.006732414091884,4.108263774124508
14,0,2,0,0,2,0.0008363726026070172,0.0005720313521707147
14,1,1,0,8,9,1.5965508043207812,1.0919500621590494
14,2,1,1,7,9,6.458295997502595,4.417107615259811
14,3,1,1,6,8,6.910408441959906,4.726326846174337
14,4,1,1,7,9,7.353665416306523,5.029489438545542
14,5,1,0,11,12,1.2383019559704949,0.8469281992995543
14,6,1,0,10,11,2.0691379112812904,1.4151727992147816
14,7,1,0,9,10,0.6852747399677248,0.4686889968541439
14,8,1,0,4,5,4.878492603524641,3.336611830481326
14,9,1,0,3,4,7.313911175431293,5.002299795925143
14,10,1,0,2,3,6.476864904960123,4.429807693201332
14,11,1,0,0,1,0.022781185160676422,0.015581036622784056
14,12,1,0,1,2,0.008179574199946676,0.005594364132913469
14,13,1,1,21,23,0.3292717314887452,0.22520316089741685
14,15,1,2,7,10,15.532790137140347,10.623546153277335
14,16,1,1,1,3,0.05176426127918053,0.03540381437812459
14,17,1,1,20,22,0.40357241624405055,0.27602060880915535
14,18,1,1,25,27,0.9848241385232075,0.6735637703265233
14,19,1,1,26,28,1.4003254573823918,0.9577430709335425
14,20,1,1,23,25,1.3085825749388622,0.8949961505626111
14,21,1,1,24,26,0.9165395598419652,0.6268609972398826
14,22,1,2,21,24,1.243146644707258,0.8502416912053132
14,23,1,1,29,31,0.979727233156703,0.6700777765725436
14,24,1,1,28,30,1.0221165404307977,0.6990696549315405
14,25,1,1,3,5,1.4037576847362536,0.960090519484663
14,26,1,1,22,24,2.298207705881118,1.571843526995634
14,27,1,2,9,12,2.0381233218148735,1.393960581724403
14,28,1,0,2,3,2.6014521568216247,1.7792455064113433
14,29,1,1,5,7,1.8534276024574095,1.2676392008531607
14,30,1,3,7,11,3.5396808158049757,2.420940615469976
14,31,1,0,4,5,0.6785552666681273,0.4640932587997617
14,32,1,1,2,4,2.1159687978044195,1.447202465487537
14,33,1,2,3,6,2.6008408349815233,1.7788273969972919
14,34,1,1,33,35,1.2274833206809266,0.8395288672864739
14,35,1,1,31,33,1.6884576615039413,1.1548091319377212
14,36,1,2,10,13,3.674555362832138,2.513187144431915
14,37,1,0,5,6,1.672163325426037,1.1436647316186364
14,38,1,1,8,10,3.2490649704863865,2.2221758849639253
14,39,1,1,27,29,0.8380636760702895,0.5731879503624779
14,40,1,1,4,6,1.9491354661774618,1.333097943196585
14,41,1,1,7,9,2.1735876870055852,1.4866105128070928
14,42,1,1,8,10,0.7385767093237883,0.5051445162112711
14,43,1,1,12,14,1.850025951695779,1.265312664954301
14,44,1,2,22,25,1.2225524180255936,0.8361564099575749
14,45,1,1,30,32,1.5916435158767976,1.0885937556093683
14,46,1,1,10,12,2.0087234069591933,1.373852709950295
14,47,1,0,1,2,2.940580536031769,2.0111900544684636
14,48,1,1,32,34,1.9120010460248185,1.3077001091382008
14,49,1,2,2,5,2.834101958158578,1.9383647554472383
14,50,1,3,8,12,3.1312569363033504,2.141601881367636
14,51,1,2,8,11,4.049948984476163,2.7699350583592093
14,52,1,1,6,8,2.3923571600129208,1.6362364057021777
14,53,1,0,6,7,0.47051036120366146,0.32180236092229414
14,54,1,2,1,4,4.494304808450902,3.0738492014586996
14,55,1,1,9,11,1.2543284553127725,0.8578894145052532
14,56,1,2,7,10,1.6437680126793686,1.124243950623232
14,57,1,1,9,11,1.3817949669554759,0.9450692680587777
14,58,1,1,10,12,1.3262930626305258,0.9071091181446269
14,59,1,1,19,21,2.620033719258403,1.791954239639839
14,60,1,1,18,20,2.3836352319399277,1.630271102327129
14,61,1,1,17,19,2.8501309046198893,1.9493276443433543
14,62,1,1,16,18,2.6301335591681463,1.7988619564424573
14,63,1,1,15,17,3.197101884392125,2.1866360857060223
14,64,1,1,14,16,3.384976750590883,2.315131822433382
14,65,1,2,6,9,3.555648733289161,2.4318617640123334
14,66,1,2,5,8,3.7204538627905417,2.544579111256239
14,67,1,2,4,7,3.7851414777976853,2.5888217655061436
14,68,1,1,13,15,1.8098404377875044,1.2378280560766637
14,69,1,1,11,13,2.335755924705302,1.597524375840574
14,70,1,0,6,7,0.35339823381781754,0.2417043180460732
14,71,1,0,7,8,4.133053459518119,2.8267737987501644
14,72,1,0,5,6,1.9122237404361588,1.3078524194659698
14,73,1,0,3,4,13.028589212590688,8.910814965631811
15,0,3,0,0,3,0.0009362221914962462,0.0006403227992697213
15,1,2,0,1,3,1.7997224478131282,1.2309079256608044
15,2,1,0,0,1,0.024305555555555556,0.01662361938490908
15,3,2,1,1,4,0.16820911599374636,0.11504548064991338
15,4,2,1,2,5,0.40984153524338524,0.2803083301033852
15,5,2,0,4,6,0.663267900925163,0.453637568991394
15,6,2,0,3,5,1.3214445258936662,0.9037929944253779
15,7,2,0,2,4,0.6793950206787276,0.4646676028429275
15,8,2,0,3,5,5.9182446582336175,4.047743175438732
15,9,2,0,4,6,10.027816251080395,6.858456711213244
15,10,2,0,5,7,9.351884447647224,6.396157752247054
15,11,2,0,7,9,0.12646730798983752,0.08649645501217906
15,12,2,0,6,8,0.0051503446902144475,0.00352254321591274
15,13,2,1,26,29,0.27728769125011815,0.18964903019501408
15,14,2,1,7,10,0.5010577463593661,0.34269503720249467
15,16,2,1,6,9,0.005584050134079681,0.0038191731039850054
15,17,2,1,25,28,0.6889330206569653,0.47119105304628045
15,18,2,1,30,33,1.2734585841856654,0.8709733360161337
15,19,2,1,31,34,2.177808816142827,1.4894975253664917
15,20,2,1,28,31,1.2863374064305375,0.8797817188829767
15,21,2,1,29,32,1.0420119937992998,0.7126770149251116
15,22,2,2,26,30,1.029923885477244,0.7044094354669874
15,23,2,1,34,37,1.314380679704535,0.8989617248757783
15,24,2,1,33,36,1.1966447051431859,0.8184370059675595
15,25,2,1,8,11,0.4719506056284601,0.3227874062994452
15,26,2,1,27,30,3.3983832512428296,2.3243011073572375
15,27,2,2,14,18,0.24256148616451936,0.16589827844997362
15,28,2,0,9,11,1.021115926428763,0.6983852917914751
15,29,2,1,10,13,1.0159001236462615,0.694817978958618
15,30,2,3,12,17,0.34671699354244395,0.23713472920853074
15,31,2,0,11,13,0.5653646575974891,0.38667731169929576
15,32,2,1,7,10,0.5164040253031541,0.35319102029381166
15,33,2,2,8,12,0.44854371829470996,0.3067784249316947
15,34,2,1,38,41,2.060371879782005,1.4091773316013314
15,35,2,1,36,39,0.9664112050695349,0.6609703697439331
15,36,2,2,15,19,0.8290092955158122,0.5669952683742092
15,37,2,0,12,14,1.4929070590811013,1.0210636276337088
15,38,2,1,3,6,0.2032823925935199,0.1390336095961372
15,39,2,1,32,35,0.8555080263115183,0.5851188950456556
15,40,2,1,9,12,0.8624117978893403,0.5898406826537496
15,41,2,1,12,15,1.5880501327453682,1.0861360856604343
15,42,2,1,13,16,0.7056199795609217,0.4826039850764469
15,43,2,1,17,20,2.76669021756053,1.8922589540301613
15,44,2,2,27,31,1.0565643953705843,0.7226300309878156
15,45,2,1,35,38,2.560702455641133,1.7513750254867286
15,46,2,1,15,18,2.2353828970694396,1.528874926371473
15,47,2,0,8,10,1.0349890129583232,0.7078736949523979
15,48,2,1,37,40,2.2177484077324916,1.5168139373471898
15,49,2,2,7,11,0.32121370941733024,0.21969193151596045
15,50,2,3,13,18,0.3995269528357763,0.27325374163012656
15,51,2,2,13,17,0.3477272727272727,0.23782570278462128
15,52,2,1,11,14,1.5379963238927759,1.0519021235842085
15,53,2,0,13,15,3.9487851296316445,2.7007447280003096
15,54,2,2,6,10,0.12992508118331933,0.08886137546653355
15,55,2,1,2,5,1.1886010430740834,0.8129355980120017
15,56,2,2,12,16,0.18373396510890555,0.1256635955952251
15,57,2,1,14,17,1.4517134902785307,0.9928895664683602
15,58,2,1,3,6,1.3809652093000213,0.9445017609547142
15,59,2,1,24,27,1.9725892372179936,1.3491389903566648
15,60,2,1,23,26,1.5704886114708903,1.074125002646116
15,61,2,1,22,25,1.5951015302796592,1.0909588410372375
15,62,2,1,21,24,1.1941199243789662,0.816710199338565
15,63,2,1,20,23,1.0997851896298119,0.752190599214146
15,64,2,1,19,22,0.854176064428972,0.5842079087766913
15,65,2,2,11,15,0.6420544654025602,0.4391287840690328
15,66,2,2,10,14,0.44874954699823644,0.3069192000733324
15,67,2,2,9,13,0.1688657010763287,0.11549454755075873
15,68,2,1,18,21,2.7694501787936296,1.8941466107410434
15,69,2,1,16,19,2.642884478924746,1.8075828612724967
15,70,2,0,1,3,0.020841347736042976,0.014254298011852044
15,71,2,0,0,2,0.04264502940746161,0.02916677777257631
15,72,2,0,2,4,2.0210488442262986,1.3822826089259679
15,73,2,0,10,12,5.447355615229255,3.7256818176748125
16,0,2,0,0,2,0.0007648100176554784,0.0005230866089939765
16,1,1,0,7,8,1.6178874115591766,1.1065430895385577
16,2,1,1,6,8,0.6145146697361973,0.4202931281610918
16,3,1,1,5,7,0.561437242137983,0.3839911826118116
16,4,1,1,6,8,0.5131958577276041,0.3509968159039121
16,5,1,0,10,11,0.5538212084144825,0.3787822481543079
16,6,1,0,9,10,1.1263157351592537,0.7703359853563126
16,7,1,0,8,9,0.60468814295434,0.41357234201309234
16,8,1,0,3,4,5.35060242225039,3.659508129495622
16,9,1,0,2,3,9.15733163143198,6.263094677032336
16,10,1,0,1,2,8.576338038480174,5.865728061312499
16,11,1,0,1,2,0.11376174863366881,0.07780657411945277
16,12,1,0,0,1,0.004197321260139596,0.0028707293238067577
16,13,0,0,20,20,0.23542870657310422,0.1610198623687979
16,14,1,1,1,3,0.45293728619282964,0.30978337580859017
16,15,1,2,6,9,1.5146735988691133,1.0359507044559328
16,17,0,0,19,19,0.6273161801862513,0.42904863415177846
16,18,0,0,24,24,1.1353697112331265,0.7765283907028233
16,19,0,0,25,25,1.9697441719285906,1.3471931273053905
16,20,0,0,22,22,1.1160739645495608,0.7633311960169401
16,21,0,0,23,23,0.9175836408607203,0.6275750893503518
16,22,0,1,20,21,0.8755731808716667,0.5988423210148693
16,23,0,0,28,28,1.1681547429481347,0.798951490125782
16,24,0,0,27,27,1.0494552571718125,0.7177677842763189
16,25,0,0,2,2,0.3493692817831421,0.2389487437086995
16,26,0,0,21,21,3.0771837407396667,2.104618887092035
16,27,0,1,8,9,0.1732642045142017,0.11850287405649466
16,28,1,0,3,4,0.6758625033664689,0.46225156165697867
16,29,0,0,4,4,0.8319205711693238,0.568986415553623
16,30,0,2,6,8,0.034485302827597604,0.02358598828440595
16,31,1,0,5,6,0.5128866054522421,0.35078530491385124
16,32,0,0,1,1,0.34513409946811735,0.23605211957395197
16,33,0,1,2,3,0.25752463689056854,0.17613222360297845
16,34,0,0,32,32,1.854230544175284,1.2681883673791305
16,35,0,0,30,30,0.7489872277175029,0.512264719449627
16,36,0,1,9,10,0.39607634768636973,0.2708937237107571
16,37,1,0,6,7,1.3416154250496446,0.9175887436915873
16,38,1,1,7,9,0.1474171781611953,0.10082497620544625
16,39,0,0,26,26,0.7390540216360999,0.5054709707203838
16,40,0,0,3,3,0.6801423731681719,0.4651787494942555
16,41,0,0,6,6,1.3542984401011189,0.9262632055604744
16,42,0,0,7,7,0.6191452889983811,0.4234602087059089
16,43,0,0,11,11,2.5256469108416897,1.7273990240847212
16,44,0,1,21,22,0.8948253753203369,0.6120097284459576
16,45,0,0,29,29,2.3102050112225,1.580049002372809
16,46,0,0,9,9,1.989398302806265,1.3606354364229438
16,47,1,0,2,3,0.6682598151584125,0.4570517547739807
16,48,0,0,31,31,1.9231775789042467,1.3153442227732859
16,49,0,1,1,2,0.1495192142166634,0.10226264946658967
16,50,0,2,7,9,0.09762518158227176,0.0667700788528315
16,51,0,1,7,8,0.30398523778859465,0.20790863554129416
16,52,0,0,5,5,1.290351656119255,0.8825272376508444
16,53,1,0,7,8,3.585919686774928,2.4525653767322932
16,54,0,1,0,1,0.3654262993250074,0.2499308316294081
16,55,1,1,8,10,1.0536236644334789,0.7206187380675558
16,56,0,1,6,7,0.024509803921568627,0.01676331366545453
16,57,0,0,8,8,1.2852786301551369,0.8790575760516887
16,58,1,1,9,11,1.2334401957749261,0.8436030314856732
16,59,0,0,18,18,1.6748896980511152,1.1455294156295464
16,60,0,0,17,17,1.3095932516866762,0.8956873960492008
16,61,0,0,16,16,1.2963081961529308,0.8866011726878146
16,62,0,0,15,15,0.9318883154753747,0.6373586742462187
16,63,0,0,14,14,0.7987516667447718,0.5463007690022466
16,64,0,0,13,13,0.5516329105344367,0.3772855767050364
16,65,0,1,5,6,0.33888898327430755,0.23178081483528304
16,66,0,1,4,5,0.15519413656936337,0.10614397400634633
16,67,0,1,3,4,0.28266618759786444,0.19332761618510558
16,68,0,0,12,12,2.5279077319161227,1.7289452972794588
16,69,0,0,10,10,2.3494297675777864,1.606876507657585
16,70,1,0,5,6,0.017238788079954947,0.011790351841300607
16,71,1,0,6,7,0.3741087410467056,0.25586912858309263
16,72,1,0,4,5,1.8033590405378253,1.233395148517123
16,73,1,0,4,5,3.6708060937526468,2.510622857349211
17,0,2,0,0,2,0.0008725521732875535,0.0005967761234279666
17,1,1,0,7,8,0.4931063540519587,0.3372567365227877
17,2,1,1,6,8,5.356075823334528,3.6632516249345852
17,3,1,1,5,7,5.677413696885501,3.8830284776651296
17,4,1,1,6,8,5.9673456286286015,4.081325450133512
17,5,1,0,10,11,0.7737071920335743,0.5291717708872963
17,6,1,0,9,10,1.1954810429705156,0.8176411271403148
17,7,1,0,8,9,0.26682777502414223,0.18249504164530925
17,8,1,0,3,4,1.246524092847622,0.8525516738859948
17,9,1,0,2,3,1.1925251052045864,0.8156194336129249
17,10,1,0,1,2,0.9043999881222192,0.6185582197409853
17,11,1,0,1,2,0.04408339868992204,0.03015054065888078
17,12,1,0,0,1,0.0052708260043790095,0.003604945591167542
17,13,0,0,1,1,0.1827926182814447,0.12501976783604746
17,14,1,1,1,3,0.24301134741577238,0.16620595799260968
17,15,1,2,6,9,12.860083052263352,8.795566323530569
17,16,0,0,19,19,0.0431701457332474,0.02952592751152024
17,18,0,0,5,5,0.28534593714743206,0.1951604126606715
17,19,0,0,6,6,0.16049882068628923,0.10977207662327221
17,20,0,0,3,3,0.6195538512079181,0.423739642049898
17,21,0,0,4,4,0.3559771084540848,0.24346812181088387
17,22,0,1,1,2,0.6862611172051454,0.4693636228558964
17,23,0,0,9,9,0.29595068095132937,0.20241345504711333
17,24,0,0,8,8,0.41466707696925037,0.283608726541287
17,25,0,0,17,17,1.020584908784465,0.6980221058858781
17,26,0,0,2,2,0.30787902912907095,0.21057176764129415
17,27,0,1,27,28,1.7833775084871948,1.219728915594456
17,28,1,0,3,4,2.3386795543231007,1.5995239724298247
17,29,0,0,15,15,1.1890357952765676,0.8132329438235106
17,30,0,2,25,27,2.9427317476944594,2.0126613610516517
17,31,1,0,5,6,0.8357915037095854,0.5716339135327121
17,32,0,0,18,18,1.6100096043472396,1.1011551168843388
17,33,0,1,21,22,2.0429729057049015,1.3972774216369381
17,34,0,0,13,13,0.1876251949144354,0.1283249757508232
17,35,0,0,11,11,1.2138801487099535,0.8302250703518166
17,36,0,1,28,29,3.0540514905825815,2.088797741953059
17,37,1,0,6,7,2.1083477691075267,1.44199011475196
17,38,1,1,7,9,2.674190132907721,1.828994150359023
17,39,0,0,7,7,0.4093952536445604,0.28000309883967706
17,40,0,0,16,16,1.3359317340732317,0.9137014219112902
17,41,0,0,13,13,1.2100269512049315,0.8275897021294379
17,42,0,0,12,12,0.32542416764722454,0.2225716457808673
17,43,0,0,8,8,0.19142272900493876,0.13092227335948922
17,44,0,1,2,3,0.6881220393179172,0.4706363878760981
17,45,0,0,10,10,0.20316375219039848,0.13895246629946767
17,46,0,0,10,10,0.6991817868254767,0.47820062695051996
17,47,1,0,2,3,2.668062785576415,1.824803392832747
17,48,0,0,12,12,0.9020177381847875,0.6169288961014139
17,49,0,1,20,21,2.2833856574506655,1.5617060877978615
17,50,0,2,26,28,2.5692437969209014,1.757216817752984
17,51,0,1,26,27,3.4909209280102336,2.387591621899434
17,52,0,0,14,14,1.4311879040042395,0.9788512313603219
17,53,1,0,7,8,2.2732047861994307,1.5547429501604413
17,54,0,1,19,20,3.7696054527134883,2.5781960068328327
17,55,1,1,8,10,0.5208275622948971,0.35621646832842757
17,56,0,1,25,26,1.3583541191862827,0.9290370596822201
17,57,0,0,11,11,0.5330327678707301,0.36456413565672446
17,58,1,1,9,11,0.4793230297966332,0.3278297256587245
17,59,0,0,1,1,1.4721316368186808,1.006854418901086
17,60,0,0,2,2,1.4436223225470886,0.9873556673381998
17,61,0,0,3,3,1.8499872879458454,1.2652862211455422
17,62,0,0,4,4,1.821255288309498,1.2456351654422375
17,63,0,0,5,5,2.348659823295239,1.6063499095030436
17,64,0,0,6,6,2.5981874384965424,1.7770126245209852
17,65,0,1,24,25,2.8165928269917226,1.9263895042906476
17,66,0,1,23,24,3.021671828269096,2.0666518921747667
17,67,0,1,22,23,3.1968904433753194,2.186491472060895
17,68,0,0,7,7,0.15771373219707094,0.10786723429649502
17,69,0,0,9,9,0.8101048881761785,0.5540657275705422
17,70,1,0,5,6,0.2907240825214846,0.19883875860469263
17,71,1,0,6,7,3.436380847502446,2.3502893048422746
17,72,1,0,4,5,0.685286841808272,0.46869727382566406
17,73,1,0,4,5,11.666427745123181,7.979173895991942
18,0,2,0,0,2,0.0006826024199211588,0.0004668612817366171
18,1,1,0,7,8,0.17175096118458674,0.11746790157496577
18,2,1,1,6,8,4.375267297830972,2.9924343058168477
18,3,1,1,5,7,4.607401432135162,3.151200867893482
18,4,1,1,6,8,4.800031020094198,3.2829485642250296
18,5,1,0,10,11,0.5127479170516187,0.35069044992566567
18,6,1,0,9,10,0.7402615202758275,0.5062968312010769
18,7,1,0,8,9,0.10821194725171221,0.07401082521650695
18,8,1,0,3,4,0.5604934366805587,0.38334567328939523
18,9,1,0,2,3,1.5399922087745832,1.0532671954722148
18,10,1,0,1,2,1.7574281135085674,1.2019810034182716
18,11,1,0,1,2,0.05077655988049165,0.034728282725280175
18,12,1,0,0,1,0.003375615967711954,0.002308729578659591
18,13,0,0,4,4,0.09919469177540315,0.06784353467290997
18,14,1,1,1,3,0.26209029492956326,0.17925487436109086
18,15,1,2,6,9,10.50603331953174,7.185530022133103
18,16,0,0,24,24,0.034531982000638874,0.02361791418727481
18,17,0,0,5,5,0.12611271329283827,0.08625393238127892
18,19,0,0,1,1,0.26763340605524366,0.1830460475087667
18,20,0,0,2,2,0.2716049382716049,0.18576234995199986
18,21,0,0,1,1,0.10054755834520769,0.0687688185605213
18,22,0,1,4,5,0.3733349867688254,0.25533992460816085
18,23,0,0,4,4,0.03866814831931372,0.02644681700487015
18,24,0,0,3,3,0.12782400281028775,0.08742435720577803
18,25,0,0,22,22,0.7474114072446935,0.5111869477566882
18,26,0,0,3,3,0.390502151248626,0.26708128997535174
18,27,0,1,32,33,1.4581570129700103,0.9972965699814602
18,28,1,0,3,4,1.8321709282916114,1.2531008431549149
18,29,0,0,20,20,0.7855077650663881,0.5372426925402877
18,30,0,2,30,32,2.35632460094105,1.6115921820346335
18,31,1,0,5,6,0.7493555505573595,0.5125166313504494
18,32,0,0,23,23,1.2210198030373092,0.8351081883618737
18,33,0,1,26,27,1.587553206069635,1.0857962160408852
18,34,0,0,8,8,0.2667349360194034,0.18243154503955075
18,35,0,0,6,6,0.8298829030146658,0.5675927662803794
18,36,0,1,33,34,2.381485722563449,1.6288009600110154
18,37,1,0,6,7,1.8889775362731507,1.291953336259809
18,38,1,1,7,9,2.151517950763,1.4715160668322418
18,39,0,0,2,2,0.18254091384646837,0.12484761629995211
18,40,0,0,21,21,0.9335213346722683,0.6384755666174036
18,41,0,0,18,18,0.6990242283895862,0.47809286593007594
18,42,0,0,17,17,0.1389308381093909,0.09502080165491389
18,43,0,0,13,13,0.4568822896674776,0.3124815340993889
18,44,0,1,5,6,0.37395018487466325,0.2557606851677946
18,45,0,0,5,5,0.3142146835317197,0.21490499537201693
18,46,0,0,15,15,0.1894034088541785,0.12954117307870003
18,47,1,0,2,3,2.114608989992135,1.4462724341843491
18,48,0,0,7,7,0.37670678252455186,0.2576460413788197
18,49,0,1,25,26,1.8081309675841852,1.2366588755596883
18,50,0,2,31,33,2.0360729367836172,1.3925582348299155
18,51,0,1,31,32,2.853258612664439,1.9514668189843478
18,52,0,0,19,19,0.8882408983440947,0.6075063202086287
18,53,1,0,7,8,2.38055539738104,1.6281646704309964
18,54,0,1,24,25,3.077913227594519,2.1051178146641134
18,55,1,1,8,10,0.22718811381357903,0.15538376500713638
18,56,0,1,30,31,1.0823889060520882,0.7402925293985014
18,57,0,0,16,16,0.17949175818335725,0.12276216702589456
18,58,1,1,9,11,0.17757659393067018,0.12145230346307725
18,59,0,0,6,6,0.8415681824663975,0.5755848336728684
18,60,0,0,7,7,0.8919304098173979,0.610029736483079
18,61,0,0,8,8,1.219628640630384,0.8341567122969692
18,62,0,0,9,9,1.2698647398520564,0.8685153506311063
18,63,0,0,10,10,1.7187239098205318,1.1755095265892288
18,64,0,0,11,11,1.9684437525009966,1.346303714283925
18,65,0,1,29,30,2.187001127516903,1.4957845442005575
18,66,0,1,28,29,2.3922094839130352,1.63613540363822
18,67,0,1,27,28,2.6095985017388745,1.7848171436023972
18,68,0,0,12,12,0.46902385310742684,0.3207856738217706
18,69,0,0,14,14,0.198773543400832,0.13594981286201707
18,70,1,0,5,6,0.2340632098375112,0.16008594016521158
18,71,1,0,6,7,2.8059465172701725,1.9191080331775772
18,72,1,0,4,5,0.238612667340676,0.1631975106770464
18,73,1,0,4,5,9.083850497959611,6.212837755645606
19,0,2,0,0,2,0.0007982035502906098,0.0005459258884819569
19,1,1,0,7,8,0.3487386094115954,0.23851739963029714
19,2,1,1,6,8,4.988587718653199,3.411910635557047
19,3,1,1,5,7,5.2764621263841365,3.608800378473513
19,4,1,1,6,8,5.529884473798632,3.7821268690949488
19,5,1,0,10,11,0.6755546357640461,0.46204099770455537
19,6,1,0,9,10,1.023950515629747,0.7003239897933383
19,7,1,0,8,9,0.20444015246822353,0.1398254515868377
19,8,1,0,3,4,0.8292434070278604,0.5671553873503428
19,9,1,0,2,3,0.9141906796535567,0.6252544966131596
19,10,1,0,1,2,0.9606056934443504,0.6569997295595875
19,11,1,0,1,2,0.04582003583176822,0.0313383018186601
19,12,1,0,0,1,0.004561537042232907,0.003119832230410029
19,13,0,0,5,5,0.15148838759444144,0.10360945220311858
19,14,1,1,1,3,0.248444839213005,0.16992215774627367
19,15,1,2,6,9,11.977948488785549,8.192236389515704
19,16,0,0,25,25,0.039939513163529027,0.02731635834167612
19,17,0,0,6,6,0.04728983109506736,0.03234355829078556
19,18,0,0,1,1,0.17842227070349578,0.1220306983391778
19,20,0,0,3,3,0.48923949268955486,0.3346120229981006
19,21,0,0,2,2,0.26027288091017486,0.17801186640539715
19,22,0,1,5,6,0.5691015227618677,0.38923311520863596
19,23,0,0,3,3,0.18786134163407742,0.12848648669334622
19,24,0,0,2,2,0.3060674767877538,0.20933276874044351
19,25,0,0,23,23,0.9182412246453996,0.6280248393067028
19,26,0,0,4,4,0.09018218576541037,0.061679492494492005
19,27,0,1,33,34,1.6618530418585615,1.136613083307844
19,28,1,0,3,4,2.1489036117127256,1.469728007422716
19,29,0,0,21,21,1.0377408744233694,0.7097558118820178
19,30,0,2,31,33,2.7233756945399787,1.862634280655109
19,31,1,0,5,6,0.8032185563381375,0.5493558677538384
19,32,0,0,24,24,1.464311717088388,1.001506037996161
19,33,0,1,27,28,1.8724187921494992,1.2806280958564575
19,34,0,0,7,7,0.10487521603962445,0.07172869060194495
19,35,0,0,5,5,1.0700917954163016,0.7318820042296288
19,36,0,1,34,35,2.8026537885194474,1.9168559937471392
19,37,1,0,6,7,2.025383927029391,1.3852475593199614
19,38,1,1,7,9,2.4785056783887365,1.695157098824375
19,39,0,0,1,1,0.324123044212089,0.22168175125823275
19,40,0,0,22,22,1.185117553680679,0.8105530891376431
19,41,0,0,19,19,1.0181417295202393,0.6963511100477143
19,42,0,0,18,18,0.2549736369814643,0.17438748456819456
19,43,0,0,14,14,0.1874308285759999,0.12819204021581743
19,44,0,1,6,7,0.5703581475920483,0.39009257521311114
19,45,0,0,4,4,0.06198769627753494,0.04239606320084925
19,46,0,0,16,16,0.500745541504871,0.3424815068160206
19,47,1,0,2,3,2.460871747357925,1.6830964916497757
19,48,0,0,6,6,0.6998285504321755,0.4786429765197449
19,49,0,1,26,27,2.105430712673487,1.4399950138470274
19,50,0,2,32,34,2.3697912409559754,1.6208025988667034
19,51,0,1,32,33,3.2525300069762606,2.2245457731004397
19,52,0,0,20,20,1.227479075852947,0.8395259640652524
19,53,1,0,7,8,2.3040173610457018,1.5758170011255654
19,54,0,1,25,26,3.5106596065043463,2.4010917567841203
19,55,1,1,8,10,0.4070818749259145,0.27842087920170094
19,56,0,1,31,32,1.2551225296353772,0.8584325162365484
19,57,0,0,17,17,0.3980557614425647,0.27224753028444465
19,58,1,1,9,11,0.3578188047771584,0.24472773748300392
19,59,0,0,7,7,1.23580306826499,0.8452191020519316
19,60,0,0,8,8,1.2369265682347832,0.8459875122137199
19,61,0,0,9,9,1.6138825078187593,1.1038039628684544
19,62,0,0,10,10,1.6147761404115986,1.1044151568014364
19,63,0,0,11,11,2.1128160708029857,1.4450461793011724
19,64,0,0,12,12,2.3624519569810025,1.6157829455171293
19,65,0,1,30,31,2.5809411798883306,1.765217163262701
19,66,0,1,29,30,2.7860907555251964,1.9055278199999162
19,67,0,1,28,29,2.977126340953639,2.0361853091437854
19,68,0,0,13,13,0.18227287141530207,0.12466429050250102
19,69,0,0,15,15,0.5749967072332517,0.3932650865261447
19,70,1,0,5,6,0.26950886974695343,0.18432875814296462
19,71,1,0,6,7,3.2002242340620533,2.1887715955231446
19,72,1,0,4,5,0.5067928093232876,0.346617494504193
19,73,1,0,4,5,10.698234897008593,7.316984983606883
20,0,2,0,0,2,0.0005591142851509227,0.0003824024119823092
20,1,1,0,7,8,0.33223181597984114,0.22722769054927677
20,2,1,1,6,8,3.6151052963935015,2.4725266758972824
20,3,1,1,5,7,3.77854342056348,2.5843090691437594
20,4,1,1,6,8,3.896350212241712,2.664882222937341
20,5,1,0,10,11,0.31638501301074934,0.21638937745564266
20,6,1,0,9,10,0.40518452888234313,0.2771232022818009
20,7,1,0,8,9,0.08849315029548596,0.060524288174415616
20,8,1,0,3,4,1.3196308649901725,0.90255255338777
20,9,1,0,2,3,2.9523037797666913,2.0192080872741904
20,10,1,0,1,2,3.048257902208784,2.0848352565953916
20,11,1,0,1,2,0.05938575336275022,0.040616482043867405
20,12,1,0,0,1,0.0018936053146302266,0.0012951184737869028
20,13,0,0,2,2,0.03388808152080902,0.023177522834195656
20,14,1,1,1,3,0.2849333026076555,0.1948781940741169
20,15,1,2,6,9,8.682777493406128,5.938526602460093
20,16,0,0,22,22,0.02777326916390612,0.018995338518393898
20,17,0,0,3,3,0.22403509798143464,0.15322728127697202
20,18,0,0,2,2,0.2222222222222222,0.15198737723345443
20,19,0,0,3,3,0.6004302864826355,0.4106602100431235
20,21,0,0,1,1,0.09873603900311995,0.06752984222926917
20,22,0,1,2,3,0.12889367807194263,0.08815595432457499
20,23,0,0,6,6,0.22930393616091482,0.1568308673088221
20,24,0,0,5,5,0.11400421836737253,0.07797240964443132
20,25,0,0,20,20,0.535730992000603,0.36640956769581784
20,26,0,0,1,1,0.915127277298281,0.6258950762011105
20,27,0,1,30,31,1.202517088504463,0.8224533826209139
20,28,1,0,3,4,1.4358975568844723,0.9820723664105813
20,29,0,0,18,18,0.47488129558654885,0.32479183176040965
20,30,0,2,28,30,1.898009282409101,1.2981305375914958
20,31,1,0,5,6,0.6821884481530561,0.4665781485618454
20,32,0,0,21,21,0.9191075185384527,0.6286173351219361
20,33,0,1,24,25,1.233773978899444,0.8438313201831441
20,34,0,0,10,10,0.5657071012244261,0.3869115236884838
20,35,0,0,8,8,0.5295747915795683,0.36219907629509335
20,36,0,1,31,32,1.8528128851276158,1.267218769117032
20,37,1,0,6,7,1.720280447805389,1.176574110155701
20,38,1,1,7,9,1.7448975192078537,1.1934107886850327
20,39,0,0,4,4,0.031862745098039214,0.021792307765090894
20,40,0,0,19,19,0.622525050756586,0.42577177376977465
20,41,0,0,16,16,0.31424241188253205,0.2149239599889343
20,42,0,0,15,15,0.045748102571460704,0.03128910355459513
20,43,0,0,11,11,0.8566471311282338,0.585897978036345
20,44,0,1,3,4,0.13069371729211596,0.08938707890453673
20,45,0,0,7,7,0.7001320939505572,0.47885058304430256
20,46,0,0,13,13,0.29922444326491654,0.20465252251188862
20,47,1,0,2,3,1.6803216664608527,1.1492445734726957
20,48,0,0,9,9,0.20820182516010757,0.14239822203586347
20,49,0,1,23,24,1.4386405967636475,0.9839484498765533
20,50,0,2,29,31,1.6194289347204263,1.1075974038185608
20,51,0,1,29,30,2.3534680757280464,1.609638481046568
20,52,0,0,17,17,0.47363163225963173,0.3239371330287364
20,53,1,0,7,8,2.5080039872376596,1.715332266500841
20,54,0,1,22,23,2.5396284867725445,1.736961627833666
20,55,1,1,8,10,0.1390859251791805,0.09512687240132456
20,56,0,1,28,29,0.866711581659315,0.5927814905141621
20,57,0,0,14,14,0.14863503435774247,0.10165792066666951
20,58,1,1,9,11,0.2022058065650361,0.13829728590537774
20,59,0,0,4,4,0.35676598418920186,0.24400766800362986
20,60,0,0,5,5,0.46526208854274415,0.3182128405369692
20,61,0,0,6,6,0.7306509734651082,0.49972376308514443
20,62,0,0,7,7,0.8413458587310609,0.5754327768664309
20,63,0,0,8,8,1.228534604151197,0.8402478854646628
20,64,0,0,9,9,1.4780123436164712,1.010876488312224
20,65,0,1,27,28,1.6964315084561044,1.1602627903189624
20,66,0,1,26,27,1.9015472897158017,1.3005503336217978
20,67,0,1,25,26,2.1515346993483515,1.4715275219132617
20,68,0,0,10,10,0.8690421392749837,0.5943754595418983
20,69,0,0,12,12,0.3473116735684806,0.2375414565670577
20,70,1,0,5,6,0.1900023647281544,0.1299508248743388
20,71,1,0,6,7,2.3167986969455003,1.5845587088698412
20,72,1,0,4,5,0.2865898267225552,0.19601116247408099
20,73,1,0,4,5,7.0676687500857085,4.833883964161683
21,0,2,0,0,2,0.0006138720348721052,0.00041985360241728726
21,1,1,0,7,8,0.21198830409356725,0.14498795854507165
21,2,1,1,6,8,3.991895966892653,2.7302300918856854
21,3,1,1,5,7,4.189375102703009,2.865294603481338
21,4,1,1,6,8,4.344250860454091,2.971220824460677
21,5,1,0,10,11,0.4129859294843156,0.2824589171548867
21,6,1,0,9,10,0.5683881814484313,0.38874523026977936
21,7,1,0,8,9,0.07345594558121546,0.050239694299915316
21,8,1,0,3,4,0.8882730017398,0.6075282771077395
21,9,1,0,2,3,2.2361650269552507,1.5294098587864746
21,10,1,0,1,2,2.4013059750085888,1.642356886844603
21,11,1,0,1,2,0.05462372001051871,0.037359521726099854
21,12,1,0,0,1,0.002627752512767994,0.0017972334559540207
21,13,0,0,3,3,0.06618461454860824,0.04526651690302544
21,14,1,1,1,3,0.2720052887272929,0.1860361669228039
21,15,1,2,6,9,9.586510342953558,6.556628537311028
21,16,0,0,23,23,0.0311217308605295,0.021285496118058016
21,17,0,0,4,4,0.17544586059522752,0.11999500289250706
21,18,0,0,1,1,0.11212576203344372,0.07668765221294498
21,19,0,0,2,2,0.43536554624974705,0.2977653038053916
21,20,0,0,1,1,0.13457356427091904,0.09204067385322615
21,22,0,1,3,4,0.25,0.17098579938763622
21,23,0,0,5,5,0.11858541225631422,0.08110568604143312
21,24,0,0,4,4,0.03801726581436386,0.026001650343205042
21,25,0,0,21,21,0.6406162106669909,0.4381450995262952
21,26,0,0,2,2,0.6550394761208403,0.44800979381992134
21,27,0,1,31,32,1.3290485294535792,0.9089937009343305
21,28,1,0,3,4,1.6300081733642366,1.114833002124259
21,29,0,0,19,19,0.6285405836587822,0.4298860565778732
21,30,0,2,29,31,2.12510212172916,1.453449140256889
21,31,1,0,5,6,0.7143131974882438,0.48854965234266334
21,32,0,0,22,22,1.0687302881508625,0.730950810597016
21,33,0,1,25,26,1.4091135286145164,0.9637536124723434
21,34,0,0,9,9,0.41398512865630777,0.28314231263156886
21,35,0,0,7,7,0.6775286996791272,0.46339114529080505
21,36,0,1,32,33,2.114333869283275,1.4460842672470189
21,37,1,0,6,7,1.8004736173889302,1.2314216829823814
21,38,1,1,7,9,1.9464337266910858,1.3312501068533245
21,39,0,0,3,3,0.09430879395927447,0.06450185809764171
21,40,0,0,20,20,0.7765427511278342,0.5311111322410679
21,41,0,0,17,17,0.5026480236773884,0.34378269655637494
21,42,0,0,16,16,0.07280109889280517,0.04979181636193861
21,43,0,0,12,12,0.6577516052517457,0.4498647360898827
21,44,0,1,4,5,0.24993150997542812,0.17093895610123022
21,45,0,0,6,6,0.5072937401304201,0.34696010272217465
21,46,0,0,14,14,0.1414888083001497,0.09677030796642046
21,47,1,0,2,3,1.8934142074863365,1.2949877673558357
21,48,0,0,8,8,0.20754758490524525,0.14195075886398667
21,49,0,1,24,25,1.6217723175621077,1.1092001445723858
21,50,0,2,30,32,1.8258764342676528,1.2487957667852057
21,51,0,1,30,31,2.6010169657651883,1.7789478604486588
21,52,0,0,18,18,0.678113027530447,0.4637907923498547
21,53,1,0,7,8,2.4338619517137783,1.6646233256517313
21,54,0,1,23,24,2.8064239228108754,1.9194345514496136
21,55,1,1,8,10,0.14515158546818344,0.09927543949464059
21,56,0,1,29,30,0.9735787756771704,0.6658725809039886
21,57,0,0,15,15,0.08624117978893404,0.05898406826537498
21,58,1,1,9,11,0.13940267779337567,0.0953435131971097
21,59,0,0,5,5,0.5960114024385227,0.40763794436038786
21,60,0,0,6,6,0.6764019006847926,0.4626204787836231
21,61,0,0,7,7,0.9728558481478693,0.6653781395380011
21,62,0,0,8,8,1.0536815225563,0.7206583097370824
21,63,0,0,9,9,1.4714613488894333,1.006395980031477
21,64,0,0,10,10,1.721067546982253,1.1771124412835148
21,65,0,1,28,29,1.9395561834542225,1.3265462579406124
21,66,0,1,27,28,2.144716455261485,1.46686423025081
21,67,0,1,26,27,2.378543591792161,1.6267887096836888
21,68,0,0,11,11,0.6704520670895914,0.45855113056962765
21,69,0,0,13,13,0.1437610909652198,0.09832442023810718
21,70,1,0,5,6,0.2118408114881191,0.14488708198088637
21,71,1,0,6,7,2.55925472699633,1.750384861328217
21,72,1,0,4,5,0.1838639207621351,0.1257524778802347
21,73,1,0,4,5,8.054039417704969,5.508505472543266
22,0,3,0,0,3,0.0005154182221443153,0.00035251678692920017
22,1,2,0,7,9,0.48664669523664444,0.3328386968175562
22,2,2,1,6,9,3.2154296370425532,2.199171227457672
22,3,2,1,5,8,3.3428969211640385,2.2863516093428045
22,4,2,1,6,9,3.4215899094378504,2.3401731433676027
22,5,2,0,10,12,0.2190830684792641,0.1498403743848929
22,6,2,0,9,11,0.25520595792027084,0.17454637889393984
22,7,2,0,8,10,0.14208857931228164,0.0971805172702561
22,8,2,0,3,5,1.8176931161400183,1.243198842018418
22,9,2,0,2,4,3.7352720040774066,2.5547138781897334
22,10,2,0,1,3,3.749231491643347,2.5642613747517498
22,11,2,0,1,3,0.0650625283354143,0.04449907367044619
22,12,2,0,0,2,0.0011121603753482616,0.0007606545233047042
22,13,1,0,0,1,0.0039707333524185515,0.002715756065673739
22,14,2,1,1,4,0.30076128500982047,0.20570363496902738
22,15,2,2,6,10,7.724429141079329,5.283070766002406
22,16,1,0,20,21,0.02420939670612903,0.01655785219395952
22,17,1,0,1,2,0.2757299131627816,0.18858359846888695
22,18,1,0,4,5,0.339395442517114,0.2321272041892371
22,19,1,0,5,6,0.7760475310389104,0.5307724298299582
22,20,1,0,2,3,0.14321519785771403,0.09795106036063889
22,21,1,0,3,4,0.20380434782608695,0.13939059732687734
22,23,1,0,8,9,0.3488961387361574,0.238625140740246
22,24,1,0,7,8,0.23118664672727102,0.15811853439363793
22,25,1,0,18,19,0.424701361081412,0.29047160690208945
22,26,1,0,1,2,1.192446350300431,0.8155655697319539
22,27,1,1,28,30,1.0677625560633142,0.730288936818686
22,28,2,0,3,5,1.2328371369459257,0.8431905735018553
22,29,1,0,16,17,0.31446747990589957,0.2150778937325027
22,30,1,2,26,29,1.6563810220712436,1.132870532597446
22,31,2,0,5,7,0.6494078321605997,0.44415806924228823
22,32,1,0,19,20,0.760441611647626,0.520098867420767
22,33,1,1,22,24,1.0476920773136373,0.7165618694062618
22,34,1,0,12,13,0.7289397897423532,0.49855341061820696
22,35,1,0,10,11,0.3742121353219618,0.2559398443943197
22,36,1,1,29,31,1.574473511060878,1.0768504476136103
22,37,2,0,6,8,1.6393338908562454,1.1212112631651965
22,38,2,1,7,10,1.530812922279477,1.0469890849155192
22,39,1,0,6,7,0.09972676156645183,0.06820744018711986
22,40,1,0,17,18,0.46014924053037987,0.3147159429188028
22,41,1,0,14,15,0.14672794732838107,0.10035358146580087
22,42,1,0,13,14,0.1019803902718557,0.06974879420998546
22,43,1,0,9,10,1.069966603327384,0.7317963799520265
22,44,0,0,1,1,0.041099746826339316,0.02810989226292437
22,45,1,0,9,10,0.9058501052962936,0.6195500175178449
22,46,1,0,11,12,0.5080419613841843,0.34747184355894944
22,47,2,0,2,4,1.4564168955388805,0.9961064285014999
22,48,1,0,11,12,0.38285245199684953,0.26184933020879175
22,49,1,1,21,23,1.244180640556521,0.8509488856327121
22,50,1,2,27,30,1.3997762554056377,0.9573674479774601
22,51,1,1,27,29,2.0899021785008216,1.4293743785317015
22,52,1,0,15,16,0.2669200288010399,0.18255813798846673
22,53,2,0,7,9,2.6009967320240905,1.7789340217190743
22,54,1,1,20,22,2.2561643951134807,1.5430882905936048
22,55,2,1,8,11,0.2224256172332686,0.1521264878676753
22,56,1,1,26,28,0.7530050013798296,0.5150126484152732
22,57,1,0,12,13,0.28466158091249383,0.1946923518690842
22,58,2,1,9,12,0.3184095431801764,0.21777404109325815
22,59,1,0,2,3,0.12470069395949483,0.08528819136342883
22,60,1,0,3,4,0.24520082300741902,0.16770343492971937
22,61,1,0,4,5,0.4749851048282183,0.32486283138509237
22,62,1,0,5,6,0.6162999205265368,0.42151413829506634
22,63,1,0,6,7,0.970633147461764,0.6638579385235484
22,64,1,0,7,8,1.219789996484214,0.8342670705355812
22,65,1,1,25,27,1.4380423361372083,0.9835392735907378
22,66,1,1,24,26,1.6430527469927767,1.1237547495224463
22,67,1,1,23,25,1.9101519718481972,1.3064354474333344
22,68,1,0,8,9,1.0814386823590239,0.7396426303674789
22,69,1,0,10,11,0.5984183087587251,0.4092841315652318
22,70,2,0,5,7,0.1668082109453499,0.11408734117164841
22,71,2,0,6,8,2.0594986762590444,1.4085801099917254
22,72,2,0,4,6,0.4620828584725209,0.31603842775699187
22,73,2,0,4,6,6.039223643997812,4.130485929798717
23,0,2,0,0,2,0.0006557788034144744,0.00044851545169316586
23,1,1,0,7,8,0.22433304208644528,0.15343105812084434
23,2,1,1,6,8,4.378311136784801,2.9945161187637583
23,3,1,1,5,7,4.611367121185912,3.1539131739433435
23,4,1,1,6,8,4.805147303879461,3.2864478117166986
23,5,1,0,10,11,0.5184806837212527,0.35461133669250633
23,6,1,0,9,10,0.7531715283754015,0.515126543421103
23,7,1,0,8,9,0.12299596475571532,0.08412225342083805
23,8,1,0,3,4,0.7230130938539755,0.4944998872814002
23,9,1,0,2,3,1.7049000052137306,1.1660547610698198
23,10,1,0,1,2,1.8781872265671313,1.2845733773369135
23,11,1,0,1,2,0.04839522532708757,0.03309958515638739
23,12,1,0,0,1,0.0033616563354071332,0.0022991819831044017
23,13,0,0,8,8,0.098452542897316,0.06733594699617249
23,14,1,1,1,3,0.2528328343630201,0.17292329718001126
23,15,1,2,6,9,10.51504543763628,7.191693799006226
23,16,0,0,28,28,0.03445249011459936,0.023563546252557625
23,17,0,0,9,9,0.1268360061219983,0.08674862359162
23,18,0,0,4,4,0.03749638624903148,0.025645398307752875
23,19,0,0,3,3,0.27325286055865805,0.18688943519032178
23,20,0,0,6,6,0.2717676280425657,0.18587362051415954
23,21,0,0,5,5,0.10311774978809933,0.07052668351428967
23,22,0,1,8,9,0.37215588131856786,0.2545334834562624
23,24,0,0,1,1,0.11875,0.0812182547091272
23,25,0,0,26,26,0.7484381086820748,0.5118891532207005
23,26,0,0,7,7,0.4176268859131911,0.2856330677345445
23,27,0,1,36,37,1.4522658979838603,0.9932673819606949
23,28,1,0,3,4,1.8065469294761647,1.2355754834710466
23,29,0,0,24,24,0.7892815125938584,0.5398237214909741
23,30,0,2,34,36,2.351953236732775,1.6086024172203677
23,31,1,0,5,6,0.7373735813002169,0.5043216449837671
23,32,0,0,27,27,1.2217638618425328,0.8356170823202842
23,33,0,1,30,31,1.5879169464830962,1.0860449938223462
23,34,0,0,4,4,0.250466106643903,0.17130458985606678
23,35,0,0,2,2,0.8197327647200369,0.5606506482395706
23,36,0,1,37,38,2.36794081231659,1.6195370107862432
23,37,1,0,6,7,1.8561812817225811,1.2695225610548109
23,38,1,1,7,9,2.150902608250389,1.4710952075065777
23,39,0,0,2,2,0.1772951114331234,0.1212597854236506
23,40,0,0,25,25,0.93607195899303,0.6402200487710955
23,41,0,0,22,22,0.7084815812840116,0.4845611581090532
23,42,0,0,21,21,0.14671059948074644,0.10034171652341903
23,43,0,0,17,17,0.4846229425372581,0.33145456492528624
23,44,0,1,9,10,0.36824324324324326,0.25185746126016684
23,45,0,0,1,1,0.30788945803217577,0.2105789004186306
23,46,0,0,19,19,0.23755919710757328,0.1624769968772938
23,47,1,0,2,3,2.0879157935872583,1.4280158040823527
23,48,0,0,3,3,0.3421870833330797,0.2340365279353213
23,49,0,1,29,30,1.8079977283422681,1.2365677474865324
23,50,0,2,35,37,2.032253451727154,1.389945924007402
23,51,0,1,35,36,2.8454690676364827,1.9461392126504635
23,52,0,0,23,23,0.8956915281554623,0.6126021277855808
23,53,1,0,7,8,2.3094527490295187,1.579534497763145
23,54,0,1,28,29,3.076753672038211,2.1043247445291944
23,55,1,1,8,10,0.24989417581732004,0.17091342165775594
23,56,0,1,34,35,1.0803534564792057,0.7389003975091714
23,57,0,0,20,20,0.20289246349304063,0.1387669202403374
23,58,1,1,9,11,0.21151649823345534,0.14466527013648364
23,59,0,0,10,10,0.8475091053631633,0.5796480874752836
23,60,0,0,11,11,0.8952047819144511,0.6122692210051078
23,61,0,0,12,12,1.221657312019293,0.8355442082934791
23,62,0,0,13,13,1.2704203617337895,0.8688953644375279
23,63,0,0,14,14,1.7182165220313863,1.1751625021623227
23,64,0,0,15,15,1.9671499004568376,1.3454187929796857
23,65,0,1,33,34,2.1851663937483905,1.4945296905202674
23,66,0,1,32,33,2.3899569311293165,1.6345947854846723
23,67,0,1,31,32,2.6068960696689762,1.7829688335713476
23,68,0,0,16,16,0.4924035010321512,0.33677602498101256
23,69,0,0,18,18,0.2509945142298321,0.1716659906299971
23,70,1,0,5,6,0.2340265430367444,0.16006086215625115
23,71,1,0,6,7,2.807130645647739,1.9199179097264405
23,72,1,0,4,5,0.28708370289714424,0.19634894572412348
23,73,1,0,4,5,8.948666023844297,6.120379254159989
24,0,2,0,0,2,0.0005834402336045002,0.0003990399789510988
24,1,1,0,7,8,0.2605171269242804,0.1781789168052735
24,2,1,1,6,8,3.985566648839996,2.7259011978584367
24,3,1,1,5,7,4.183226390585908,2.86108923365515
24,4,1,1,6,8,4.338492705263359,2.967282573387536
24,5,1,0,10,11,0.41790738592110344,0.2858249138068691
24,6,1,0,9,10,0.5816696855082775,0.3978290246247511
24,7,1,0,8,9,0.09450270984011944,0.06463448554524262
24,8,1,0,3,4,1.013310179886276,0.6930466045419376
24,9,1,0,2,3,2.375822226093527,1.6249274501260604
24,10,1,0,1,2,2.5115037871107915,1.717725930816858
24,11,1,0,1,2,0.052641993211209014,0.03600413316230837
24,12,1,0,0,1,0.002595529616742685,0.0017751948254121322
24,13,0,0,7,7,0.06464913259901472,0.0442163344686393
24,14,1,1,1,3,0.2637720104337542,0.18040507224039753
24,15,1,2,6,9,9.573157641145487,6.547496047740476
24,16,0,0,27,27,0.030951675787555765,0.02116918810768867
24,17,0,0,8,8,0.17771446155825016,0.12154659708912299
24,18,0,0,3,3,0.12395054817967295,0.08477513426014838
24,19,0,0,2,2,0.44518905714582374,0.30448402725882695
24,20,0,0,5,5,0.1351161106576267,0.09241174476377047
24,21,0,0,4,4,0.033058492012490316,0.022610130733221774
24,22,0,1,7,8,0.24659908984242243,0.16865977001988047
24,23,0,0,1,1,0.11875,0.0812182547091272
24,25,0,0,25,25,0.6393359473929522,0.4372694721689427
24,26,0,0,6,6,0.6812513382823513,0.46593721864041926
24,27,0,1,35,36,1.3195213093738691,0.9024776235692459
24,28,1,0,3,4,1.597092324989572,1.0923204315368018
24,29,0,0,23,23,0.6299416882634812,0.4308443325413139
24,30,0,2,33,35,2.114672617162708,1.446315951554842
24,31,1,0,5,6,0.7012148419278206,0.4795911211580135
24,32,0,0,26,26,1.0659573063047734,0.7290542485264523
24,33,0,1,29,30,1.4052090175253087,0.9610831486731193
24,34,0,0,5,5,0.4100772051409895,0.2804695149267191
24,35,0,0,3,3,0.6621330220498665,0.45286137630459106
24,36,0,1,36,37,2.0930003958332537,1.4314933832007517
24,37,1,0,6,7,1.7648318782937868,1.2070447579793868
24,38,1,1,7,9,1.9406956808452938,1.327325609429862
24,39,0,0,1,1,0.08416618925309624,0.057564892603406956
24,40,0,0,24,24,0.7761036217423296,0.5308107926850075
24,41,0,0,21,21,0.512348178853708,0.35041705170440346
24,42,0,0,20,20,0.08683317338436963,0.05938895825796664
24,43,0,0,16,16,0.6840054909573519,0.46782090262750153
24,44,0,1,8,9,0.23986486486486486,0.16405394265570503
24,45,0,0,2,2,0.5111636384819663,0.3496068933749268
24,46,0,0,18,18,0.20820416105678352,0.14239981965650514
24,47,1,0,2,3,1.8590058573812447,1.2714544103625207
24,48,0,0,4,4,0.14289856542317003,0.09773450176090864
24,49,0,1,28,29,1.6170679978039586,1.1059826570746971
24,50,0,2,34,36,1.8165761928718327,1.2424349299469566
24,51,0,1,34,35,2.5863796133074186,1.7689367428050176
24,52,0,0,22,22,0.6837505341127041,0.4676465266279358
24,53,1,0,7,8,2.3687169522760634,1.6200678464318723
24,54,0,1,27,28,2.7983982088979484,1.9139454190133807
24,55,1,1,8,10,0.17893984332302937,0.12238468861154622
24,56,0,1,33,34,0.96869740558697,0.6625340010360693
24,57,0,0,19,19,0.13107681272817473,0.08964909442204179
24,58,1,1,9,11,0.1828379206166475,0.1250507520600426
24,59,0,0,9,9,0.6003592939963162,0.4106116552150281
24,60,0,0,10,10,0.6766387262197697,0.462782453997277
24,61,0,0,11,11,0.9703019990640825,0.6636314518295744
24,62,0,0,12,12,1.0496116283237815,0.7178747332620012
24,63,0,0,13,13,1.4652109446236394,1.0021210585519464
24,64,0,0,14,14,1.7137741052056623,1.1721241413936847
24,65,0,1,32,33,1.9315711211791995,1.3210849289155928
24,66,0,1,31,32,2.136210861107172,1.4610468869878424
24,67,0,1,30,31,2.369878432477544,1.6208622329147646
24,68,0,0,15,15,0.6937554552608233,0.47448932438922153
24,69,0,0,17,17,0.21961381921872936,0.1502033777427451
24,70,1,0,5,6,0.21125116908484673,0.14448380007018088
24,71,1,0,6,7,2.5543556800201146,1.7470341914743537
24,72,1,0,4,5,0.24721149321288285,0.16907861913926395
24,73,1,0,4,5,7.880901729642356,5.390089128553214
25,0,2,0,0,2,0.0006107695138187116,0.00041773165424756136
25,1,1,0,7,8,1.0929934464198587,0.7475454326461883
25,2,1,1,6,8,1.6919166595978337,1.1571748901543792
25,3,1,1,5,7,1.6803202788960865,1.1492436244572126
25,4,1,1,6,8,1.6073264742790678,1.0993200083260695
25,5,1,0,10,11,0.21874304655638427,0.14960781870372117
25,6,1,0,9,10,0.54022354477278,0.3694822186039851
25,7,1,0,8,9,0.38674075475257735,0.26450870842858887
25,8,1,0,3,4,3.7200401002015338,2.544296121148086
25,9,1,0,2,3,6.668767753398331,4.561058340981218
25,10,1,0,1,2,6.3655115933317346,4.35364835318837
25,11,1,0,1,2,0.09321865607678474,0.06375626570852069
25,12,1,0,0,1,0.0018761219500265194,0.0012831608454959011
25,13,0,0,18,18,0.1322209255662521,0.09043160261487505
25,14,1,1,1,3,0.3901842596820662,0.2668638702008445
25,15,1,2,6,9,4.066641051831898,2.781351484280219
25,16,0,0,2,2,0.011098243851421472,0.0075905683869368756
25,17,0,0,17,17,0.47110928378711464,0.32221198994910627
25,18,0,0,22,22,0.7806296920111243,0.5339063676569854
25,19,0,0,23,23,1.438577918611126,0.9839055815805011
25,20,0,0,20,20,0.6838837601587945,0.46773764567589593
25,21,0,0,21,21,0.5999974291935404,0.4103641602447366
25,22,0,1,18,19,0.4879346748424222,0.33371960170751164
25,23,0,0,26,26,0.8061302128929848,0.5513472754481296
25,24,0,0,25,25,0.6886180933378256,0.470975660648632
25,26,0,0,19,19,2.2323791928966115,1.526820563335013
25,27,0,1,10,11,0.5853090689738796,0.40031815618932765
25,28,1,0,3,4,0.7306866004386948,0.4997481299113783
25,29,0,0,2,2,0.3200031887596224,0.21886400414662674
25,30,0,2,8,10,0.7614006191078242,0.5207547740495698
25,31,1,0,5,6,0.5805071028509896,0.39703388412470886
25,32,0,0,1,1,0.15702479338842976,0.1073960392847963
25,33,0,1,4,5,0.34193928786685024,0.23386704991180976
25,34,0,0,30,30,1.3598399786271125,0.9300533031392919
25,35,0,0,28,28,0.32795722489072365,0.2243041130515647
25,36,0,1,11,12,0.6329239917199637,0.4328840587034066
25,37,1,0,6,7,1.4887381951678793,1.0182123615187466
25,38,1,1,7,9,0.7222245963873607,0.49396059980282314
25,39,0,0,24,24,0.4574616272140874,0.31287776807347834
25,40,0,0,1,1,0.16809116809116809,0.11496481098427962
25,41,0,0,4,4,0.7065240616832876,0.4832223258940661
25,42,0,0,5,5,0.38133391608347084,0.26081073790060016
25,43,0,0,9,9,1.8666675852437482,1.2766945970155634
25,44,0,1,19,20,0.5088906523482218,0.34805229997062553
25,45,0,0,27,27,1.6893140287569692,1.1553948384950348
25,46,0,0,7,7,1.314395303902881,0.8989717269967566
25,47,1,0,2,3,0.8519636223976285,0.5826947240993791
25,48,0,0,29,29,1.2471423334968628,0.8529745153724925
25,49,0,1,3,4,0.5084175084175084,0.3477286963977518
25,50,0,2,9,11,0.5873075217590732,0.4016849843773867
25,51,0,1,9,10,1.1250022956817716,0.7694376673602945
25,52,0,0,3,3,0.601926148923102,0.41168329498375195
25,53,1,0,7,8,3.1897065695765816,2.1815781104441867
25,54,0,1,2,3,1.1862770418057567,0.8113461131534307
25,55,1,1,8,10,0.6591745592550566,0.4508379558008746
25,56,0,1,8,9,0.33218516211599053,0.22719578195645668
25,57,0,0,6,6,0.8282061205042875,0.5664459422886343
25,58,1,1,9,11,0.8056859304928343,0.5510434115227552
25,59,0,0,16,16,0.8837538156976772,0.6044374105557644
25,60,0,0,15,15,0.617490283719737,0.4223282791036701
25,61,0,0,14,14,0.505835289321998,0.3459626052127923
25,62,0,0,13,13,0.24214024236515547,0.16561017161888836
25,63,0,0,12,12,0.060309178955831676,0.04124805269669955
25,64,0,0,11,11,0.25499240309812193,0.174400319526027
25,65,0,1,7,8,0.47039464881921766,0.3217232202240814
25,66,0,1,6,7,0.6745726278389835,0.4613693600642681
25,67,0,1,5,6,1.005740899508638,0.6878696467172991
25,68,0,0,10,10,1.8752027355793348,1.2825321550276592
25,69,0,0,8,8,1.556163811030254,1.0643276528284737
25,70,1,0,5,6,0.07908878041857942,0.05409223336985612
25,71,1,0,6,7,1.0809519097767484,0.7393097055710774
25,72,1,0,4,5,1.1805683210094144,0.8074416723980571
25,73,1,0,4,5,3.653010113754915,2.498451417886016
26,0,2,0,0,2,0.0008081679879946078,0.0005527409978670225
26,1,1,0,7,8,0.30534562866166237,0.20883906562493867
26,2,1,1,6,8,4.930724273326171,3.3723353257387885
26,3,1,1,5,7,5.212931854243643,3.565349281004488
26,4,1,1,6,8,5.460114862640709,3.7344084181477406
26,5,1,0,10,11,0.6575208248337556,0.4497068953928706
26,6,1,0,9,10,0.9912239823237476,0.6779408999592887
26,7,1,0,8,9,0.18897043559246868,0.12924504396163233
26,8,1,0,3,4,0.6751339016254234,0.46175323945246705
26,9,1,0,2,3,0.6925320891081108,0.4736526114309602
26,10,1,0,1,2,0.8468271920811119,0.5791816975247052
26,11,1,0,1,2,0.048553002405366655,0.033207495715805765
26,12,1,0,0,1,0.004470245560602393,0.0030573940425545286
26,13,0,0,1,1,0.1476685424897364,0.10099689512805882
26,14,1,1,1,3,0.2582394680264267,0.176621127495746
26,15,1,2,6,9,11.837701658495856,8.096315523961044
26,16,0,0,21,21,0.039516522384921066,0.0270270566760206
26,17,0,0,2,2,0.05745242597140699,0.03929419592592007
26,18,0,0,3,3,0.1648786860827532,0.11276765576737073
26,19,0,0,4,4,0.05711538431809324,0.03906367857984494
26,20,0,0,1,1,0.47225086655639686,0.3229927677185978
26,21,0,0,2,2,0.24801313498053557,0.16962689657312238
26,22,0,1,1,2,0.5538250826950891,0.3787848979421742
26,23,0,0,7,7,0.18184170657470194,0.12436939824274959
26,24,0,0,6,6,0.2966281868771071,0.20287683061634923
26,25,0,0,19,19,0.9024511630858641,0.6172253341141541
26,27,0,1,29,30,1.6481703045586613,1.1272548682077062
26,28,1,0,3,4,2.1404049186766616,1.4639153841326298
26,29,0,0,17,17,1.0134694904945414,0.6931555639487582
26,30,0,2,27,29,2.693847478256909,1.8424386579925025
26,31,1,0,5,6,0.8082781201693358,0.5528163220187591
26,32,0,0,20,20,1.4421638894015423,0.9863581819092212
26,33,0,1,23,24,1.8467178467245693,1.2630501090624588
26,34,0,0,11,11,0.15376248556964717,0.105164806043824
26,35,0,0,9,9,1.0565355465440391,0.7226103000291426
26,36,0,1,30,31,2.775571482555212,1.8983332348089184
26,37,1,0,6,7,2.0402075757531373,1.3953860930274464
26,38,1,1,7,9,2.449566043144306,1.6753640321593524
26,39,0,0,5,5,0.31579201770317517,0.2159838023488479
26,40,0,0,18,18,1.1613941855587016,0.7943276528876292
26,41,0,0,15,15,0.9855688519747248,0.6740731120258129
26,42,0,0,14,14,0.24186773244895646,0.16542379031543894
26,43,0,0,10,10,0.16356161086482626,0.11186685113140721
26,44,0,1,2,3,0.5577599365520064,0.38147611447096824
26,45,0,0,8,8,0.12384672060285501,0.08470412209526561
26,46,0,0,12,12,0.45874402461435465,0.31375485505194756
26,47,1,0,2,3,2.4506465275061147,1.6761030220886712
26,48,0,0,10,10,0.6912741858336676,0.47279227704322824
26,49,0,1,22,23,2.078883967592896,1.4218385481320488
26,50,0,2,28,30,2.3428795827869284,1.6023965533271782
26,51,0,1,28,29,3.2227064366553004,2.2041481450527485
26,52,0,0,16,16,1.193811086915599,0.8164989720563463
26,53,1,0,7,8,2.3756674851502257,1.6248216161105071
26,54,0,1,21,22,3.472499508343796,2.374992417229351
26,55,1,1,8,10,0.38030704030575735,0.2601084131977036
26,56,0,1,27,28,1.241223320987967,0.8489262470308165
26,57,0,0,13,13,0.3711776485879886,0.2538644278345614
26,58,1,1,9,11,0.3261861313579249,0.22309278567758126
26,59,0,0,3,3,1.1994107622737773,0.8203288319260638
26,60,0,0,4,4,1.2056493657222263,0.8245956823168458
26,61,0,0,5,5,1.5786947723709053,1.0797375505716866
26,62,0,0,6,6,1.584419012116754,1.0836526054070084
26,63,0,0,7,7,2.0785577173394114,1.4216154114904789
26,64,0,0,8,8,2.3285112592193373,1.5925694361629195
26,65,0,1,26,27,2.5472280883955456,1.7421593236678115
26,66,0,1,25,26,2.7525588888999715,1.8825939279204214
26,67,0,1,24,25,2.9460992631029175,2.0149645503079134
26,68,0,0,9,9,0.1715084365705632,0.1173020285149658
26,69,0,0,11,11,0.5290979068428736,0.36187291422341533
26,70,1,0,5,6,0.26634732033636593,0.18216643792987341
26,71,1,0,6,7,3.163652853615386,2.163758848641613
26,72,1,0,4,5,0.46226872136904607,0.31616554742074726
26,73,1,0,4,5,10.658193001015933,7.289598601225676
27,0,3,0,0,3,0.0008170027185460971,0.0005587834517299056
27,1,2,0,7,9,1.8139174697278893,1.2406165143384864
27,2,2,1,6,9,0.6983397694832906,0.4776247349171122
27,3,2,1,5,8,0.7778812816477362,0.5320266110848687
27,4,2,1,6,9,0.917206450573238,0.6273171126190462
27,5,2,0,10,12,0.6840075660788786,0.4678223218927539
27,6,2,0,9,11,1.3512745571586933,0.9241950413918132
27,7,2,0,8,10,0.6865979264317283,0.46959398123529
27,8,2,0,3,5,5.95754435239418,4.074621933925666
27,9,2,0,2,4,10.079221785711216,6.893615176940442
27,10,2,0,1,3,9.393431178568786,6.424573356241319
27,11,2,0,1,3,0.12007317719218799,0.08212323274887821
27,12,2,0,0,2,0.00506297458817043,0.003462787028950437
27,13,1,0,20,21,0.27321055734565736,0.18686050219555542
27,14,2,1,1,4,0.4700832822895596,0.3215102632041768
27,15,2,2,6,10,1.7343146260763134,1.1861726909173114
27,16,1,0,0,1,0.004567148616687713,0.0031236702285859425
27,17,1,0,19,20,0.6830972778044702,0.46719973641966217
27,18,1,0,24,25,1.2637360779073423,0.8643236939839322
27,19,1,0,25,26,2.16040895441613,1.4775970083001972
27,20,1,0,22,23,1.2737773604158384,0.8711913608503015
27,21,1,0,23,24,1.0329018462601185,0.7064461914870067
27,22,1,1,20,22,1.0179336367803593,0.696208786433814
27,23,1,0,28,29,1.2979626463230751,0.887732722627371
27,24,1,0,27,28,1.1793221702528955,0.8065893760650135
27,25,1,0,2,3,0.48568199340385754,0.33217889556135693
27,26,1,0,21,22,3.38308641462041,2.3138389400052914
27,28,2,0,3,5,0.7490788910252835,0.5123274119454484
27,29,1,0,4,5,1.026399492579447,0.7019989509190439
27,30,0,1,2,3,0.31662554557570227,0.21655388806723158
27,31,2,0,5,7,0.47412361848121803,0.3242736236582789
27,32,1,0,1,2,0.5444030826140591,0.3723407850794331
27,33,0,0,6,6,0.4965568229920293,0.33961666128270845
27,34,1,0,32,33,2.0287361409592015,1.3875402832339894
27,35,1,0,30,31,0.9125,0.6240981677648723
27,36,0,0,1,1,0.642512077294686,0.4394417646097704
27,37,2,0,6,8,1.2524378234240654,0.8565963296858999
27,38,2,1,7,10,0.3268557863576012,0.22355079165931552
27,39,1,0,26,27,0.8408228259814061,0.5750750521752083
27,40,1,0,3,4,0.8768867925753728,0.5997407568038419
27,41,1,0,6,7,1.5973381965694373,1.0924885937313218
27,42,1,0,7,8,0.7073923946438779,0.4838162163156708
27,43,1,0,11,12,2.7663995359163587,1.8920601442969778
27,44,1,1,21,23,1.0353779000487806,0.7081396716325316
27,45,1,0,29,30,2.5313153493705958,1.7312759140572997
27,46,1,0,9,10,2.238531409373785,1.5310283299444345
27,47,2,0,2,4,0.7096372801963299,0.48535159051854987
27,48,1,0,31,32,2.1640009242142204,1.4800537116094084
27,49,0,0,7,7,0.39370910417535737,0.26927466361445457
27,50,0,1,3,4,0.3765702127290264,0.25755263539617923
27,51,0,0,1,1,0.12600832977844648,0.08618253998667423
27,52,1,0,5,6,1.5500835060536724,1.0601690696007082
27,53,2,0,7,9,3.680213580758595,2.517057044092974
27,54,0,0,8,8,0.38018648421997436,0.2600259596829091
27,55,2,1,8,11,1.202123494666696,0.8221841867929756
27,56,0,0,2,2,0.17021877954684986,0.11641997636642377
27,57,1,0,8,9,1.4543146940928247,0.9946686421225891
27,58,2,1,9,12,1.3937309021702857,0.953232769755351
27,59,1,0,18,19,1.9691725939387301,1.3468022004273559
27,60,1,0,17,18,1.568564889632648,1.072809286180871
27,61,1,0,16,17,1.5945969888220046,1.0906137633393924
27,62,1,0,15,16,1.1959282778665203,0.8179470104051445
27,63,1,0,14,15,1.10613883766405,0.7565361335667934
27,64,1,0,13,14,0.8668592238091841,0.5928824693582367
27,65,0,0,3,3,0.6640015353167952,0.45413933324304
27,66,0,0,4,4,0.4862691322766664,0.33258046519943213
27,67,0,0,5,5,0.2647145343992698,0.18104970509514032
27,68,1,0,12,13,2.765505716789142,1.8914488227850776
27,69,1,0,10,11,2.641056109899552,1.806332360715103
27,70,2,0,5,7,0.035917569483642844,0.024565577320886562
27,71,2,0,6,8,0.422022602674747,0.2886394883119696
27,72,2,0,4,6,2.0358669632499247,1.3924173606326713
27,73,2,0,4,6,4.115639099581105,2.8148633657315463
28,0,1,0,0,1,0.0004474260158818887,0.00030601397996955987
28,1,0,0,10,10,1.4256844892127116,0.9750872082503573
28,2,0,1,9,10,1.8322347824008542,1.2531445157385672
28,3,0,1,8,9,1.8977423939396356,1.2979480010383002
28,4,0,1,9,10,1.9432035117263946,1.329040823301598
28,5,0,0,13,13,0.5108109057845821,0.34936564424599725
28,6,0,0,12,12,1.0073532670593197,0.6889724145355391
28,7,0,0,11,11,0.5318574620735043,0.36376029325167014
28,8,0,0,6,6,4.726584303019858,3.232715181699615
28,9,0,0,5,5,8.144317610237199,5.570250628212842
28,10,0,0,4,4,7.652329490030486,5.233758700121782
28,11,0,0,2,2,0.09190620780380943,0.06285862564008227
28,12,0,0,3,3,0.0033581438436520077,0.002296779638262031
28,13,0,1,23,24,0.1906428307522566,0.13038886725478574
28,14,0,1,2,3,0.3650424800701312,0.24966832106094658
28,15,0,2,9,11,4.441854279965119,3.0379760192929166
28,16,0,1,3,4,0.010838716643849364,0.007413066518738644
28,17,0,1,22,23,0.5449958604270797,0.3727462114323074
28,18,0,1,27,28,0.9660537621901224,0.660725899118046
28,19,0,1,28,29,1.6995874019909738,1.16242124223433
28,20,0,1,25,26,0.9253562033255488,0.632891080575708
28,21,0,1,26,27,0.7707103863189597,0.527122126004405
28,22,0,2,23,25,0.7150455394286368,0.4890505326310761
28,23,0,1,31,32,0.9823098929026646,0.6718441691373817
28,24,0,1,30,31,0.8684189517130798,0.5939492346481361
28,25,0,1,5,6,0.3688766009951632,0.2522906419862084
28,26,0,1,24,25,2.6729458553809025,1.8281431352086908
28,27,0,2,11,13,0.45573331132307454,0.31169569817660153
28,29,0,1,7,8,0.7264183873425754,0.49682891459859124
28,30,0,3,9,12,0.7687754060842477,0.525798709435479
28,31,0,0,2,2,0.41324006520758244,0.28263273155406965
28,32,0,1,4,5,0.48912619571803595,0.33453453430512714
28,33,0,2,5,7,0.5836058032703428,0.3991532191977725
28,34,0,1,35,36,1.5727194208338584,1.0756507495349503
28,35,0,1,33,34,0.5252883540858979,0.35926739652957185
28,36,0,2,12,14,0.5118265724738428,0.3500603025690957
28,37,0,0,3,3,1.0496670650065174,0.7179126488040531
28,38,0,1,10,11,0.7989039988955513,0.5464049555405402
28,39,0,1,29,30,0.6008457886274212,0.41094438990861726
28,40,0,1,6,7,0.6256724209684851,0.42792439621637623
28,41,0,1,9,10,1.1586401927251953,0.7924440782230496
28,42,0,1,10,11,0.5309969658837778,0.36317176273618856
28,43,0,1,14,15,2.227700808374494,1.523620814065585
28,44,0,2,24,26,0.7137587805884684,0.4881704626754549
28,45,0,1,32,33,1.976973632828207,1.3521376679096409
28,46,0,1,12,13,1.7186965201630475,1.1754907936193093
28,47,0,0,1,1,0.1271004086889137,0.08692945992867669
28,48,0,1,34,35,1.5441722701823135,1.0561261200373755
28,49,0,2,4,6,0.6540051947241411,0.4473024040942958
28,50,0,3,10,13,0.6433068417232146,0.4399853383343177
28,51,0,2,10,12,0.9713722507807071,0.6643634432108265
28,52,0,1,8,9,1.109817006079042,0.7590517918336726
28,53,0,0,4,4,2.9020441071768706,1.984833326095265
28,54,0,2,3,5,1.2081841772476083,0.8263293494167036
28,55,0,1,11,12,0.9259386380834557,0.6332894328663955
28,56,0,2,9,11,0.346722169720626,0.23713826942038765
28,57,0,1,11,12,1.1069924486616065,0.7571199550019266
28,58,0,1,12,13,1.084508781454606,0.7417424037597083
28,59,0,1,21,22,1.4034091202500503,0.9598521211754166
28,60,0,1,20,21,1.097541558732302,0.7506560831239798
28,61,0,1,19,20,1.097202095975607,0.7504239098807165
28,62,0,1,18,19,0.8196100042593619,0.5605666870575637
28,63,0,1,17,18,0.7966530052926661,0.5448654037781173
28,64,0,1,16,17,0.7331833307953219,0.5014557516549114
28,65,0,2,8,10,0.7450744402783674,0.5095885950971691
28,66,0,2,7,9,0.8116226130067332,0.5551037651441536
28,67,0,2,6,8,0.9827704073745359,0.6721591348777917
28,68,0,1,15,16,2.2250735342714467,1.5218239078147053
28,69,0,1,13,14,2.019863592364644,1.381471963977805
28,70,0,0,8,8,0.0878761623156932,0.0601023034426659
28,71,0,0,9,9,1.1546933467927971,0.7897446597958059
28,72,0,0,7,7,1.578737008514233,1.0797664376946063
28,73,0,0,1,1,0.3143376380761059,0.21498908929625776
29,0,2,0,0,2,0.0005556442229363044,0.0003800290865355439
29,1,1,0,7,8,0.7666508310844219,0.5243456208166623
29,2,1,1,6,8,2.4674408546390683,1.6875893878886938
29,3,1,1,5,7,2.5257682554172423,1.72748201688173
29,4,1,1,6,8,2.5287804474077737,1.72954218510337
29,5,1,0,10,11,0.04947916643077769,0.033840939300801676
29,6,1,0,9,10,0.18949749797088036,0.1296055246900318
29,7,1,0,8,9,0.251754541059313,0.17218580580997644
29,8,1,0,3,4,2.7046409456022253,1.8498207765613153
29,9,1,0,2,3,5.116439327197078,3.499353873516528
29,10,1,0,1,2,4.985258714504301,3.409633785814791
29,11,1,0,1,2,0.0798337024590344,0.05460171773213079
29,12,1,0,0,1,0.0005663318426083356,0.000387338811308237
29,13,0,0,16,16,0.06761260239236155,0.046243179474945384
29,14,1,1,1,3,0.3487632585269319,0.23853425822505714
29,15,1,2,6,9,5.9260840546031925,4.053104877258605
29,16,0,0,4,4,0.017890764971383307,0.012236267001153182
29,17,0,0,15,15,0.3715736860239274,0.2541352949448471
29,18,0,0,20,20,0.5554095308550219,0.3798685704830317
29,19,0,0,21,21,1.1006342607520585,0.7527713156324431
29,20,0,0,18,18,0.41039124309948666,0.28068429905220593
29,21,0,0,19,19,0.39853116717495246,0.27257268080118774
29,22,0,1,16,17,0.24458581770458857,0.167282806236391
29,23,0,0,24,24,0.5755177695996884,0.39362146358716865
29,24,0,0,23,23,0.45933248102545504,0.31415732581137473
29,25,0,0,2,2,0.21663658813514092,0.14816712079558872
29,26,0,0,17,17,1.6971977113544952,1.1607868295792603
29,27,0,1,12,13,0.8373888634098053,0.5727264168337188
29,28,1,0,3,4,0.9741242742141815,0.6662456709176511
29,30,0,2,10,12,1.224321311425686,0.83736623256576
29,31,1,0,5,6,0.622244000520247,0.4255795513724607
29,32,0,0,3,3,0.4655667758770024,0.3184212293666149
29,33,0,1,6,7,0.7032332050513432,0.48097156688653364
29,34,0,0,28,28,1.0432300990209384,0.7135101297053522
29,35,0,0,26,26,0.2215005643333669,0.15149380422941314
29,36,0,1,13,14,1.1161014797099793,0.7633500148237379
29,37,1,0,6,7,1.582438374017051,1.082297961451907
29,38,1,1,7,9,1.137037037037037,0.7776687468445085
29,39,0,0,22,22,0.27956461056624154,0.19120631367264812
29,40,0,0,1,1,0.15100387019399478,0.1032780698229882
29,41,0,0,2,2,0.30074646332532085,0.2056934977787376
29,42,0,0,3,3,0.232,0.1586748218317264
29,43,0,0,7,7,1.451851851851852,0.9929841979252355
29,44,0,1,17,18,0.2690003950999241,0.183980990367002
29,45,0,0,25,25,1.2929126369305444,0.8842788030557832
29,46,0,0,5,5,0.8901515151515151,0.6088130735771895
29,47,1,0,2,3,1.1555365666842587,0.7903213743046104
29,48,0,0,27,27,0.8200390234616887,0.5608601118226136
29,49,0,1,5,6,0.885523485807211,0.6056477643890884
29,50,0,2,11,13,1.0072944754334507,0.6889322044029531
29,51,0,1,11,12,1.6266838065867535,1.1125593240806362
29,52,0,0,1,1,0.17119705591120055,0.11708906183114592
29,53,1,0,7,8,2.9236962906567436,1.9996421896984407
29,54,0,1,4,5,1.7353010413066707,1.1868473429040747
29,55,1,1,8,10,0.4151186038880173,0.2839175453058886
29,56,0,1,10,11,0.5498068585415667,0.3760366608661393
29,57,0,0,4,4,0.541025641025641,0.3700308068799102
29,58,1,1,9,11,0.5401942310467929,0.3694621696805014
29,59,0,0,14,14,0.38608329116504997,0.2640590406802623
29,60,0,0,13,13,0.18484654015751317,0.12642453373148477
29,61,0,0,12,12,0.0580786242466861,0.0397224799766151
29,62,0,0,11,11,0.20748218873575175,0.1419060315987157
29,63,0,0,10,10,0.5011396848556747,0.3427510784796625
29,64,0,0,9,9,0.7500166080218981,0.5129687571065107
29,65,0,1,9,10,0.9682587011272729,0.6622339521051244
29,66,0,1,8,9,1.1733111947636286,0.8024782102684863
29,67,0,1,7,8,1.4718303985929295,1.0066483890657412
29,68,0,0,8,8,1.4634615920190317,1.0009246007379073
29,69,0,0,6,6,1.056265943757218,0.7224259070370558
29,70,1,0,5,6,0.12405062750024695,0.08484358283067046
29,71,1,0,6,7,1.5801695434456275,1.080746210216187
29,72,1,0,4,5,0.7926806524100655,0.5421485400457922
29,73,1,0,4,5,4.778655043161222,3.268328610210723
30,0,4,0,0,4,0.0007789680227699381,0.0005327698802828971
30,1,3,0,7,10,1.6258236805166135,1.1119710467059283
30,2,3,1,6,10,0.5619424534484421,0.3843367184509257
30,3,3,1,5,9,0.5000143478198517,0.34198141186905967
30,4,3,1,6,10,0.44601308150667157,0.3050476131150448
30,5,3,0,10,13,0.557483815585037,0.3812872634139085
30,6,3,0,9,12,1.1335180047655518,0.7752619286604653
30,7,3,0,8,11,0.6078428340677023,0.41572997154044966
30,8,3,0,3,6,5.375774016919959,3.6767240704413733
30,9,3,0,2,5,9.196733623217526,6.290043401284003
30,10,3,0,1,4,8.611785893292387,5.889972380479072
30,11,3,0,1,4,0.11468507124592041,0.07843807433924686
30,12,3,0,0,3,0.004245685087234215,0.002903807434355633
30,13,2,0,20,22,0.23759862643664523,0.1625039642986966
30,14,3,1,1,5,0.4567330084909646,0.3123794342541905
30,15,3,2,6,11,1.3868679741697758,0.948538916834123
30,16,2,0,0,2,0.000508539027872407,0.0003478118088022997
30,17,2,0,19,21,0.6305853745059556,0.43128457736821113
30,18,2,0,24,26,1.1424604125774789,0.7813780276531556
30,19,2,0,25,27,1.980636868756348,1.3546431132037158
30,20,2,0,22,24,1.1247462414276155,0.7692625407949605
30,21,2,0,23,25,0.9239574442300696,0.631934408807343
30,22,2,1,20,23,0.8834032117713299,0.6041976173853045
30,23,2,0,28,30,1.1759766183663876,0.8043012086101838
30,24,2,0,27,29,1.057336308581354,0.723157975777421
30,25,2,0,2,4,0.3534548328546959,0.24174302857233412
30,26,2,0,21,23,3.093413372161044,2.1157190331014384
30,27,1,0,2,3,0.17713317235004322,0.12114902828936033
30,28,3,0,3,6,0.7069199136406875,0.4834930661475669
30,29,2,0,4,6,0.8395346135490417,0.5741939880450926
30,31,3,0,5,8,0.5191228144287721,0.3550505176218526
30,32,2,0,1,3,0.34916200718787926,0.23880697965924447
30,33,1,0,4,5,0.25788804450062813,0.17638077376581682
30,34,2,0,32,34,1.8657376809369286,1.2760585952905412
30,35,2,0,30,32,0.7620039876276855,0.5211674438443451
30,36,1,0,3,4,0.4294493075336569,0.29371893258043663
30,37,3,0,6,9,1.358867276838728,0.9293880303678811
30,38,3,1,7,11,0.1167841853735375,0.07987374916771281
30,39,2,0,26,28,0.7453134542694951,0.5097520670905203
30,40,2,0,3,5,0.6871503114480332,0.4699717812096205
30,41,2,0,6,8,1.3645586063215156,0.9332805764526525
30,42,2,0,7,9,0.6231193928756974,0.4261782700191587
30,43,2,0,11,13,2.537305338611084,1.7353727264517327
30,44,2,1,21,24,0.9035132451475905,0.6179517379155124
30,45,2,0,29,31,2.323737862380614,1.5893047038658652
30,46,2,0,9,11,2.000918959275616,1.368514911046473
30,47,3,0,2,5,0.7026981729179479,0.4806056352984269
30,48,2,0,31,33,1.9399268027428251,1.326799740481933
30,49,1,0,5,6,0.13810871583834133,0.09445851672007476
30,50,0,0,1,1,0.10607751488591247,0.0725509947192865
30,51,1,0,1,2,0.29754505180096624,0.20350391414409535
30,52,2,0,5,7,1.300944126894685,0.8897718859829529
30,53,3,0,7,10,3.616020464543861,2.4731525989283347
30,54,1,0,6,7,0.33330629936510786,0.22796257615151103
30,55,3,1,8,12,1.0592718190830912,0.7244817550188717
30,56,1,0,0,1,0.026470588235294117,0.018104378758690896
30,57,2,0,8,10,1.293020382438618,0.8843524948630967
30,58,3,1,9,13,1.239772215930124,0.8479337735975736
30,59,2,0,18,20,1.6888281338138658,1.155062513953975
30,60,2,0,17,19,1.321612017649398,0.9039075492723564
30,61,2,0,16,18,1.309748695516878,0.8957937107994686
30,62,2,0,15,17,0.9432279443899682,0.6451143363051024
30,63,2,0,14,16,0.8108057295816608,0.5545450632823834
30,64,2,0,13,15,0.5620392103577755,0.38440289468088035
30,65,1,0,1,2,0.34583090012257706,0.2365286916416185
30,66,1,0,2,3,0.14973669492186095,0.10241139391550802
30,67,1,0,3,4,0.2597157233292671,0.17763080226797162
30,68,2,0,12,14,2.5397766912112023,1.7370629912513327
30,69,2,0,10,12,2.363467232625381,1.6164773363877407
30,70,3,0,5,8,0.013920948120754478,0.009521137770644067
30,71,3,0,6,9,0.3410725972306081,0.23327428274677126
30,72,3,0,4,7,1.8129156877513806,1.2399313523702247
30,73,3,0,4,7,3.827323406745652,2.6176718088696664
31,0,1,0,0,1,0.0009340789149593803,0.0006388569198618621
31,1,0,0,12,12,2.5914500479686238,1.7724046321001732
31,2,0,1,11,12,4.451498579425074,3.0445721723036936
31,3,0,1,10,11,4.861656469474257,3.3250968711245164
31,4,0,1,11,12,5.314680951658554,3.634939884038324
31,5,0,0,15,15,1.361711880170874,0.9313335774666323
31,6,0,0,14,14,2.4615711054737153,1.6835748128757222
31,7,0,0,13,13,1.030822150859884,0.7050237979650393
31,8,0,0,8,8,8.2796399690161,5.6628034349761665
31,9,0,0,7,7,13.37675582682951,9.14894115305466
31,10,0,0,6,6,12.220446622488954,8.358091338480852
31,11,0,0,4,4,0.12010604551267005,0.08214571281308683
31,12,0,0,5,5,0.009305230559995065,0.006364249143148073
31,13,0,1,25,26,0.43817711611938726,0.29968825789217013
31,14,0,1,4,5,0.4158887118288522,0.2844442553934023
31,15,0,2,11,13,10.741928494352294,7.346868922286618
31,16,0,1,5,6,0.03592569770909714,0.024571136565394183
31,17,0,1,24,25,0.8507163519901138,0.5818416619886533
31,18,0,1,29,30,1.725788540677555,1.1803413328070955
31,19,0,1,30,31,2.774755012804475,1.897774815876896
31,20,0,1,27,28,1.9202341503567506,1.3133310848407498
31,21,0,1,28,29,1.4752120382909382,1.008961238533761
31,22,0,2,25,27,1.645166508140186,1.1252004420804635
31,23,0,1,33,34,1.751262255588015,1.1977639068364467
31,24,0,1,32,33,1.665385249578574,1.139028912750282
31,25,0,1,7,8,1.2800350043522788,0.8754712338533231
31,26,0,1,26,27,4.408789746378195,3.0153617564659583
31,27,0,2,13,15,1.2599089162437962,0.8617061327982236
31,28,0,0,2,2,1.8049566066538083,1.2344877929947868
31,29,0,1,9,10,2.0267376016945184,1.3861733958988716
31,30,0,3,11,14,2.4658333685366673,1.6864899587037996
31,32,0,1,6,7,1.7726737594693645,1.2124081592654226
31,33,0,2,7,9,2.03851571147522,1.3942289539633859
31,34,0,1,37,38,2.5536035586778785,1.7465197831985988
31,35,0,1,35,36,1.7554951202677693,1.2006589458403165
31,36,0,2,14,16,2.6878501624248896,1.8383368346256306
31,37,0,0,1,1,0.11930282481532582,0.08159635548100645
31,38,0,1,12,13,2.2907280157735133,1.5667278438267516
31,39,0,1,31,32,1.2469729249269512,0.8528586495334946
31,40,0,1,8,9,1.9521704517409297,1.3351737009273832
31,41,0,1,11,12,2.7340383809513384,1.8699269524937732
31,42,0,1,12,13,1.0793125384037543,0.738188468672259
31,43,0,1,16,17,3.5741278061591397,2.444500400198796
31,44,0,2,26,28,1.6398500013555706,1.1215642534303942
31,45,0,1,34,35,3.222521690527213,2.2040217891951697
31,46,0,1,14,15,3.2206192974830903,2.2027206604135743
31,47,0,0,3,3,1.9195279819817974,1.3128481057843753
31,48,0,1,36,37,3.0547012947258856,2.0892421710766116
31,49,0,2,6,8,2.0996586832568793,1.4360472735914769
31,50,0,3,12,15,2.256318607161851,1.5431937628750678
31,51,0,2,12,14,2.5818992064750894,1.7658723990297869
31,52,0,1,10,11,2.8199265853467823,1.928669605639868
31,53,0,0,2,2,2.9800107382356864,2.038158073043875
31,54,0,2,5,7,3.0294752198443384,2.071988968760477
31,55,0,1,13,14,1.8378648588879547,1.2569951682536087
31,56,0,2,11,13,1.1632624580585136,0.7956054451550464
31,57,0,1,13,14,2.138237090846859,1.462432713034976
31,58,0,1,14,15,2.0528231901180924,1.4040144566552781
31,59,0,1,23,24,3.3242483050587883,2.273597015213887
31,60,0,1,22,23,2.820183325686207,1.9288452014485542
31,61,0,1,21,22,3.117549313115453,2.132226645733688
31,62,0,1,20,21,2.63177560372634,1.7999850216481086
31,63,0,1,19,20,2.8990311445118158,1.982772630776027
31,64,0,1,18,19,2.816827205460235,1.926549805849839
31,65,0,2,10,12,2.761507152882447,1.8887140322011222
31,66,0,2,9,11,2.724576101238746,1.863455290651025
31,67,0,2,8,10,2.516697709521569,1.7212782787183143
31,68,0,1,17,18,3.5485160039726225,2.4269833823163176
31,69,0,1,15,16,3.7777519291337778,2.5837677339644953
31,70,0,0,10,10,0.24923936446551556,0.17046556788801037
31,71,0,0,11,11,2.8348644892680066,1.938886283412453
31,72,0,0,9,9,2.982883935251346,2.0401231765979584
31,73,0,0,1,1,9.334841903128375,6.384501619854435
32,0,2,0,0,2,0.0006630691472861865,0.00045350163279202763
32,1,1,0,7,8,1.2593491215620627,0.8613232650336269
32,2,1,1,6,8,1.2984904132857746,0.8880936852514012
32,3,1,1,5,7,1.2519096982458373,0.8562351220627957
32,4,1,1,6,8,1.1413339835789797,0.7806076142021086
32,5,1,0,10,11,0.32273472525513225,0.22073221995159178
32,6,1,0,9,10,0.7237219820737926,0.4949847265571678
32,7,1,0,8,9,0.4556366699717626,0.31162960098176967
32,8,1,0,3,4,4.237438899825231,2.8981675105715317
32,9,1,0,2,3,7.459474488532134,5.101856833733383
32,10,1,0,1,2,7.068469975499897,4.834431956833422
32,11,1,0,1,2,0.10037679899707186,0.06865202886594565
32,12,1,0,0,1,0.0026255751320057755,0.001795744251193224
32,13,0,0,19,19,0.16570753997285356,0.11333454474726821
32,14,1,1,1,3,0.4129552008618303,0.28243790052256773
32,15,1,2,6,9,3.124244353084082,2.1368056727775606
32,16,0,0,1,1,0.007697921849887963,0.005264941284506579
32,17,0,0,18,18,0.5218156128375429,0.3568922387759062
32,18,0,0,23,23,0.8954145222273601,0.612412671465374
32,19,0,0,24,24,1.6107428887972268,1.101656641795777
32,20,0,0,21,21,0.8237926647640947,0.5634273892574391
32,21,0,0,22,22,0.7028063307948607,0.48067960914260294
32,22,0,1,19,20,0.6134229000624184,0.41954641971941875
32,23,0,0,27,27,0.9239589205184155,0.6319354185047149
32,24,0,0,26,26,0.8061302128929848,0.5513472754481296
32,25,0,0,1,1,0.1102514506769826,0.07540572971060167
32,26,0,0,20,20,2.5048109658026787,1.7131484212107524
32,27,0,1,9,10,0.4606487622118962,0.3150575873749049
32,28,1,0,3,4,0.6802789618607167,0.4652721684013837
32,29,0,0,3,3,0.4828592561238625,0.330248303600232
32,30,0,2,7,9,0.5281075358716675,0.3611955567346073
32,31,1,0,5,6,0.5644566444626135,0.38605628229241096
32,33,0,1,3,4,0.1580727450129241,0.10811277866973122
32,34,0,0,31,31,1.5217090971766503,1.0407625856647509
32,35,0,0,29,29,0.45973061422350475,0.31442962630389987
32,36,0,1,10,11,0.4409122399653966,0.3015589272411065
32,37,1,0,6,7,1.4559623951380891,0.9957955760440946
32,38,1,1,7,9,0.5111144659041805,0.3495732621248442
32,39,0,0,25,25,0.5492244258863354,0.3756383100135625
32,40,0,0,2,2,0.33048433048433046,0.226032509731804
32,41,0,0,5,5,0.9130452754755718,0.6244711052171806
32,42,0,0,6,6,0.4573338192417244,0.3127903546801879
32,43,0,0,10,10,2.0777786030235372,1.4210825415540222
32,44,0,1,20,21,0.6345648276523578,0.434006297277664
32,45,0,0,28,28,1.8915376128473695,1.2937042832179546
32,46,0,0,8,8,1.5303042022947808,1.0466411493425283
32,47,1,0,2,3,0.762471538630933,0.5214872221725241
32,48,0,0,30,30,1.4690799842078033,1.004767261856589
32,49,0,1,2,3,0.3164983164983165,0.216466870605223
32,50,0,2,8,10,0.37697006997204585,0.25782611503753367
32,51,0,1,8,9,0.8726858418196073,0.5968675451111913
32,52,0,0,4,4,0.8211560979972727,0.5616241273523833
32,53,1,0,7,8,3.3393083116118523,2.283897204250922
32,54,0,1,1,2,0.9068660572276559,0.6202448709303384
32,55,1,1,8,10,0.7837956755255844,0.5360717205452575
32,56,0,1,7,8,0.222808003406881,0.15238801828995488
32,57,0,0,7,7,0.9743598178134002,0.6664067693600634
32,58,1,1,9,11,0.9410953356801861,0.6436557530850099
32,59,0,0,17,17,1.1377580512968548,0.7781618796428478
32,60,0,0,16,16,0.8395484582616606,0.5742034570421103
32,61,0,0,15,15,0.7590926818362479,0.5191762760523019
32,62,0,0,14,14,0.4620038644868474,0.31598440035784303
32,63,0,0,13,13,0.2636764514436554,0.1803397153191547
32,64,0,0,12,12,0.060638739764313054,0.04147345356983965
32,65,0,1,6,7,0.22045165402011407,0.15077640915582327
32,66,0,1,5,6,0.4217391599141607,0.2884456295639717
32,67,0,1,4,5,0.7687274161091029,0.5257658870184281
32,68,0,0,11,11,2.084741180165669,1.4258445488278042
32,69,0,0,9,9,1.8105774682390414,1.2383321430403802
32,70,1,0,5,6,0.0562080630210747,0.03844312235075637
32,71,1,0,6,7,0.8273575332845244,0.565865556832149
32,72,1,0,4,5,1.3782338689816127,0.9426336793237429
32,73,1,0,4,5,3.4904163843226086,2.3872465426764164
33,0,3,0,0,3,0.0007187116754650088,0.0004915579614344477
33,1,2,0,7,9,1.4023417418975888,0.9591220950120377
33,2,2,1,6,9,0.9612789372580932,0.65746019008629
33,3,2,1,5,8,0.8855052823909819,0.6056353142863863
33,4,2,1,6,9,0.7447766795747288,0.5093849436894177
33,5,2,0,10,12,0.41273894170898107,0.2822899915460685
33,6,2,0,9,11,0.8818417312235265,0.6031296533865269
33,7,2,0,8,10,0.5148680146830039,0.3521404762787946
33,8,2,0,3,5,4.682149149819667,3.2023240609362285
33,9,2,0,2,4,8.13906072059794,5.566655214303797
33,10,2,0,1,3,7.672630927908032,5.247643730458624
33,11,2,0,1,3,0.10671464754587492,0.0729867572680051
33,12,2,0,0,2,0.00327773711827502,0.002241786005403126
33,13,1,0,20,21,0.19465332358636972,0.13313181654750258
33,14,2,1,1,4,0.4334734724969206,0.296471232832882
33,15,2,2,6,10,2.3174758778560016,1.5850218621470895
33,16,1,0,0,1,0.004905231178867972,0.0033548994971995894
33,17,1,0,19,20,0.5654657149718924,0.3867464292030811
33,18,1,0,24,25,0.9942252401648218,0.6799935898437867
33,19,1,0,25,26,1.75893886535256,1.2030142718651573
33,20,1,0,22,23,0.9443702060711793,0.6458955784117895
33,21,1,0,23,24,0.7913499888958334,0.5412384417870044
33,22,1,1,20,22,0.7217434310382835,0.4936315100354248
33,23,1,0,28,29,1.0255296946036663,0.7014040585102652
33,24,1,0,27,28,0.9075308238184285,0.6206995335180563
33,25,1,0,2,3,0.2050312944656162,0.14022975913474087
33,26,1,0,21,22,2.7391508731321363,1.8734236067433603
33,27,0,0,6,6,0.358817284679555,0.245410641020139
33,28,2,0,3,5,0.6931716437310586,0.47409003046478726
33,29,1,0,4,5,0.6228636959026183,0.42600338781378694
33,30,0,1,4,5,0.33310539081331136,0.22782516611418008
33,31,2,0,5,7,0.5543332197871212,0.3791324348496927
33,32,1,0,1,2,0.13499325331682221,0.09232771732125808
33,34,1,0,32,33,1.6613520098782943,1.136270405893185
33,35,1,0,30,31,0.5841693744323571,0.3995386698603678
33,36,0,0,7,7,0.3743961352657005,0.2560656899041895
33,37,2,0,6,8,1.4380501757733763,0.9835446354565661
33,38,2,1,7,10,0.32965043629713525,0.22546217347499486
33,39,1,0,26,27,0.6285436088463744,0.42988812563434836
33,40,1,0,3,4,0.4700876284160069,0.32151323570779616
33,41,1,0,6,7,1.0905797101449275,0.7458945741402682
33,42,1,0,7,8,0.5226683673441719,0.35747547441989574
33,43,1,0,11,12,2.2592622950799273,1.5452070782023481
33,44,1,1,21,23,0.7435161933968599,0.5085228427424577
33,45,1,0,29,30,2.0657688999399673,1.412868586825413
33,46,1,0,9,10,1.715913271785662,1.1735872098245028
33,47,2,0,2,4,0.7419036372362953,0.5074199459257713
33,48,1,0,31,32,1.6615558973444138,1.1364098533387033
33,49,0,0,1,1,0.1515245040136336,0.10363415378234495
33,50,0,1,5,6,0.20658703366702094,0.14129379637870434
33,51,0,0,5,5,0.6607698052553477,0.4519290134511933
33,52,1,0,5,6,1.0096153846153846,0.6905195744500694
33,53,2,0,7,9,3.476147292621531,2.3774872944722394
33,54,0,0,2,2,0.6666666666666666,0.4559621317003633
33,55,2,1,8,11,0.8909428126939014,0.6093542761485431
33,56,0,0,4,4,0.13243642973151593,0.09057899522275106
33,57,1,0,8,9,1.1000029884604674,0.7523395612428074
33,58,2,1,9,12,1.0574973933591758,0.723268148615441
33,59,1,0,18,19,1.3563514639230585,0.9276673572378993
33,60,1,0,17,18,1.030748650031139,0.7049735275732048
33,61,1,0,16,17,0.9774466660707146,0.6685179982275243
33,62,1,0,15,16,0.6526857496101325,0.44639997858402836
33,63,1,0,14,15,0.47953681447968777,0.3279759422384401
33,64,1,0,13,14,0.2339494435890204,0.16000813051344542
33,65,0,0,3,3,0.06285771357289609,0.042991105611762837
33,66,0,0,2,2,0.20826024440711244,0.14243817748245846
33,67,0,0,1,1,0.5655166025659881,0.38678123342690257
33,68,1,0,12,13,2.2648968597857007,1.5490608004040203
33,69,1,0,10,11,2.0293321499470394,1.3879479195269
33,70,2,0,5,7,0.03653647603280812,0.024988874245107633
33,71,2,0,6,8,0.6096529324320183,0.4169679760036209
33,72,2,0,4,6,1.5481371113777356,1.0588378462023527
33,73,2,0,4,6,3.640054944640259,2.489590818096931
34,0,2,0,0,2,0.0007498554250817179,0.0005128585171310133
34,1,1,0,7,8,0.40343460628691563,0.27592635462641824
34,2,1,1,6,8,4.975781673268117,3.403152027928397
34,3,1,1,5,7,5.263687936978025,3.6000635585249814
34,4,1,1,6,8,5.517420301278269,3.77360208308655
34,5,1,0,10,11,0.6801855935316007,0.46520830976781824
34,6,1,0,9,10,1.0359559828720066,0.7085350474470976
34,7,1,0,8,9,0.21921388895157753,0.149929848157032
34,8,1,0,3,4,1.0571480423625987,0.7230292123777746
34,9,1,0,2,3,1.4203723320764858,0.9714539945127163
34,10,1,0,1,2,1.3861426896842977,0.9480428634439912
34,11,1,0,1,2,0.04077074438323528,0.027884873279985855
34,12,1,0,0,1,0.004513399897399315,0.0030869091576515885
34,13,0,0,12,12,0.1495037378475384,0.10225206450920382
34,14,1,1,1,3,0.22965816967578628,0.15707314291166286
34,15,1,2,6,9,11.95015690273563,8.173228523287722
34,16,0,0,32,32,0.03964806324872497,0.0271170231550192
34,17,0,0,13,13,0.058297828419842435,0.03987240317972006
34,18,0,0,8,8,0.18752274289848966,0.12825490439144174
34,19,0,0,7,7,0.11059568236905852,0.07564116463477831
34,20,0,0,10,10,0.4860890647558032,0.33245730924343797
34,21,0,0,9,9,0.2609906245876723,0.17850276231120643
34,22,0,1,12,13,0.5637134374007532,0.38554797087808007
34,23,0,0,4,4,0.18158792731682966,0.12419582764564842
34,24,0,0,5,5,0.2973059737272174,0.20334039832187134
34,25,0,0,30,30,0.9153274904491976,0.62603201062374
34,26,0,0,11,11,0.25602557405855125,0.17510694977631938
34,27,0,1,40,41,1.6456880584004714,1.1255571528331663
34,28,1,0,3,4,2.096959227778478,1.4342009993799336
34,29,0,0,28,28,1.0372687841693904,0.7094329289641788
34,30,0,2,38,40,2.7053196373585466,1.8502849631712848
34,31,1,0,5,6,0.7795210863332471,0.5331481443448355
34,32,0,0,31,31,1.4588285559710035,0.9977558672488521
34,33,0,1,34,35,1.865001611089182,1.2755551653252528
34,35,0,0,2,2,1.0486120309046738,0.7171910654069134
34,36,0,1,41,42,2.7681169958939407,1.8932347893657104
34,37,1,0,6,7,1.9608862425943396,1.341134806792846
34,38,1,1,7,9,2.4679565084997677,1.6879420658390094
34,39,0,0,6,6,0.3161669705215117,0.2162402487783516
34,40,0,0,29,29,1.1826493595457053,0.8088649845487936
34,41,0,0,26,26,1.0242350540353145,0.700518597900268
34,42,0,0,25,25,0.261744574389274,0.17901842114930652
34,43,0,0,21,21,0.3130670438370987,0.21412007500964186
34,44,0,1,13,14,0.5591485550066507,0.38242585061701545
34,45,0,0,3,3,0.06844202820263143,0.04681045961575231
34,46,0,0,23,23,0.5380388152898395,0.3679879877356399
34,47,1,0,2,3,2.4058423175562536,1.6454594874718371
34,48,0,0,1,1,0.6600121211008173,0.4514108005278105
34,49,0,1,33,34,2.096689662312221,1.4340166319129926
34,50,0,2,39,41,2.3537712374205686,1.6098458264239264
34,51,0,1,39,40,3.227334346402782,2.2073133724434166
34,52,0,0,27,27,1.2304040924709372,0.8415265092838491
34,53,1,0,7,8,2.16192876848429,1.4786364747936571
34,54,0,1,32,33,3.495926393051818,2.3910150756652033
34,55,1,1,8,10,0.43007203983642234,0.29414484610280806
34,56,0,1,38,39,1.2466949771347728,0.8526685490317599
34,57,0,0,24,24,0.417500152554823,0.285546389316186
34,58,1,1,9,11,0.39102204877779656,0.26743687035385133
34,59,0,0,14,14,1.235561138966826,0.8450536361541641
34,60,0,0,15,15,1.2337768650705052,0.8438332941602085
34,61,0,0,16,16,1.6073862042949272,1.0993608602641058
34,62,0,0,17,17,1.6068474634363876,1.0989923921186653
34,63,0,0,18,18,2.1014946337004856,1.4373029594084215
34,64,0,0,19,19,2.3494838450879123,1.6069134936027756
34,65,0,1,37,38,2.5667944431389675,1.755541598895436
34,66,0,1,36,37,2.771006452861211,1.89521101380309
34,67,0,1,35,36,2.9616559979173815,2.0256044732603637
34,68,0,0,20,20,0.2989040680026154,0.20443340403057428
34,69,0,0,22,22,0.6121649242251067,0.4186860357028065
34,70,1,0,5,6,0.2684159562570394,0.18358126739602673
34,71,1,0,6,7,3.1906629777467534,2.182232239306258
34,72,1,0,4,5,0.5520860630610364,0.377595507293057
34,73,1,0,4,5,10.426990270703437,7.131469066573329
35,0,2,0,0,2,0.00041825226931329826,0.0002860607944569089
35,1,1,0,7,8,0.8804738838342812,0.6021941234693653
35,2,1,1,6,8,2.408874030198382,1.6475330067103495
35,3,1,1,5,7,2.4699874341181496,1.6893311036004328
35,4,1,1,6,8,2.4794387032231255,1.695795234813001
35,5,1,0,10,11,0.1968638462645735,0.13464368849629132
35,6,1,0,9,10,0.4110574255716076,0.28113993002234045
35,7,1,0,8,9,0.30380809273034204,0.20778747838372255
35,8,1,0,3,4,3.041883931257021,2.080475822521549
35,9,1,0,2,3,5.598859010746942,3.8293015344449444
35,10,1,0,1,2,5.401911774124461,3.694600811680621
35,11,1,0,1,2,0.07593506651428696,0.05193527219799472
35,12,1,0,0,1,0.0008202889619330274,0.000561031055539892
35,13,0,0,10,10,0.07988175075890858,0.0546345800399836
35,14,1,1,1,3,0.326798257065279,0.22351144489117183
35,15,1,2,6,9,5.79846723041721,3.9658222184635985
35,16,0,0,30,30,0.016567459414949373,0.011331201167549354
35,17,0,0,11,11,0.3901757620853422,0.26685805832736964
35,18,0,0,6,6,0.6035512021924843,0.41279473911300313
35,19,0,0,5,5,1.1673728677268744,0.7984167318868679
35,20,0,0,8,8,0.4707331480707274,0.3219547344845275
35,21,0,0,7,7,0.441866543268996,0.3022116164940033
35,22,0,1,10,11,0.2993697082575694,0.2047518755154558
35,23,0,0,2,2,0.6147995735400277,0.42048798617967786
35,24,0,0,3,3,0.4965997665373998,0.3396460322284433
35,25,0,0,28,28,0.22836479876336657,0.15618855067420365
35,26,0,0,9,9,1.8198698409371008,1.2446875981363221
35,27,0,1,38,39,0.7657342657342657,0.5237187421803123
35,28,1,0,3,4,0.724535660808135,0.49554123659251287
35,29,0,0,26,26,0.22782915188574882,0.1558221986359678
35,30,0,2,36,38,1.1430059814415283,0.7817511657665176
35,31,1,0,5,6,0.5543668800845587,0.37915545658115263
35,32,0,0,29,29,0.4559311876596741,0.3118310343509751
35,33,0,1,32,33,0.6783902412762857,0.4639803908055884
35,34,0,0,2,2,1.084771066453111,0.7419217918002552
35,36,0,1,39,40,0.9444444444444444,0.6459463532421813
35,37,1,0,6,7,1.4007178563569767,0.9580114495429355
35,38,1,1,7,9,1.0911321061066257,0.7462723816006259
35,39,0,0,4,4,0.30573681317766543,0.20910661361364605
35,40,0,0,27,27,0.23595609466540915,0.161380565866999
35,41,0,0,24,24,0.47429875054432297,0.3243934040415125
35,42,0,0,23,23,0.2811547616527239,0.1922938866913253
35,43,0,0,19,19,1.5611122094807435,1.0677120762874557
35,44,0,1,11,12,0.299477570434869,0.20482564711789286
35,45,0,0,1,1,1.3589285714285715,0.9294299523856511
35,46,0,0,21,21,1.0175126600268753,0.6959208622469416
35,47,1,0,2,3,0.8992787426290273,0.6150555787229305
35,48,0,0,1,1,0.8500023529379199,0.5813533271938477
35,49,0,1,31,32,0.8502550210846913,0.5815261378540698
35,50,0,2,37,39,0.9352686178373989,0.6396706090523891
35,51,0,1,37,38,1.5142590174408164,1.035667154308218
35,52,0,0,25,25,0.3940243361961198,0.2694902644107051
35,53,1,0,7,8,2.725548752086449,1.8641205285819034
35,54,0,1,30,31,1.6688170959718043,1.1413761007459704
35,55,1,1,8,10,0.5124557067843232,0.3504905947010945
35,56,0,1,36,37,0.5118529711277328,0.3500783577488483
35,57,0,0,22,22,0.6300313591226829,0.43090566231548344
35,58,1,1,9,11,0.638016386386002,0.43636696739448616
35,59,0,0,12,12,0.55930658856548,0.3825339365945615
35,60,0,0,13,13,0.36343347785016394,0.2485678549377563
35,61,0,0,14,14,0.30150458429266014,0.2062120094572698
35,62,0,0,15,15,0.27269010579562314,0.18650454289825488
35,63,0,0,16,16,0.4880844628964523,0.3338220482281399
35,64,0,0,17,17,0.7066733030238461,0.48332439849373443
35,65,0,1,35,36,0.911285819436818,0.6232677372280857
35,66,0,1,34,35,1.10829657988841,0.7580119066832121
35,67,0,1,33,34,1.4022706041353865,0.9590734408234907
35,68,0,0,18,18,1.566929275718533,1.071690619170493
35,69,0,0,20,20,1.197155046631814,0.8187860505571346
35,70,1,0,5,6,0.11930641422199867,0.08159881043128357
35,71,1,0,6,7,1.5367213397633885,1.0510301068619292
35,72,1,0,4,5,0.929234720249065,0.6355437658421316
35,73,1,0,4,5,3.4568382769145063,2.3642810245280237
36,0,3,0,0,3,0.0006124817843924677,0.0004189027500588478
36,1,2,0,7,9,1.4316837253346804,0.9791903449864773
36,2,2,1,6,9,1.1771294238763874,0.8050896620968472
36,3,2,1,5,8,1.1566683437718568,0.7910954455448165
36,4,2,1,6,9,1.1016873014534254,0.7534915356568868
36,5,2,0,10,12,0.4523630924021006,0.3093906598713453
36,6,2,0,9,11,0.9386107576233043,0.6419564428242223
36,7,2,0,8,10,0.5288864195758423,0.36172826894576066
36,8,2,0,3,5,4.766543613199078,3.260045080075505
36,9,2,0,2,4,8.254420930142544,5.645555044889835
36,10,2,0,1,3,7.7693958362158355,5.3138254312573485
36,11,2,0,1,3,0.10171463063331145,0.06956702971301963
36,12,2,0,0,2,0.0032873820669664924,0.0022483826024513823
36,13,1,0,20,21,0.19440630193598743,0.13296286777007593
36,14,2,1,1,4,0.40894245167002824,0.27969340800935827
36,15,2,2,6,10,2.860082069529552,1.9561336758910217
36,16,1,0,0,1,0.005037653085780555,0.003445468559639122
36,17,1,0,19,20,0.5644541594201735,0.3860545826645385
36,18,1,0,24,25,0.9958940294356241,0.6811349469136972
36,19,1,0,25,26,1.7580282855258351,1.202391486986842
36,20,1,0,22,23,0.9469932523985592,0.6476895931042608
36,21,1,0,23,24,0.792875200981228,0.542281600217632
36,22,1,1,20,22,0.7242578150880039,0.49535120590226067
36,23,1,0,28,29,1.0211744753115295,0.6984253359015674
36,24,1,0,27,28,0.9026064207030906,0.6173315215053241
36,25,1,0,2,3,0.25341444155905707,0.17332108346538716
36,26,1,0,21,22,2.7490109898991815,1.8801673665332348
36,27,0,0,1,1,0.31002331002331,0.21203833397254657
36,28,2,0,3,5,0.40593141954822015,0.2776340330720414
36,29,1,0,4,5,0.6600943037141878,0.4514670087671821
36,30,0,1,3,4,0.3704000277477791,0.2533325793506266
36,31,2,0,5,7,0.48805700317715106,0.33380326733991716
36,32,1,0,1,2,0.251429293864565,0.17196335520360617
36,33,0,0,7,7,0.25,0.1709857993876362
36,34,1,0,32,33,1.6465523510058786,1.1261482798813276
36,35,1,0,30,31,0.5430555555555555,0.3714191531142543
36,37,2,0,6,8,1.2603789361083968,0.8620275996873309
36,38,2,1,7,10,0.4346647794652157,0.297286019130042
36,39,1,0,26,27,0.6238348317156849,0.4266675895470316
36,40,1,0,3,4,0.5187532733040323,0.3547977724833716
36,41,1,0,6,7,1.126148798499607,0.7702218101635255
36,42,1,0,7,8,0.5325264729987086,0.3642178587230507
36,43,1,0,11,12,2.2769563408916023,1.5573088004723907
36,44,1,1,21,23,0.7364770159459412,0.5037084452085506
36,45,1,0,29,30,2.056536679041952,1.406554272143931
36,46,1,0,9,10,1.740204655129832,1.1902011362218405
36,47,2,0,2,4,0.41916956592768045,0.2866881732364517
36,48,1,0,31,32,1.6320012254897358,1.1161961365678579
36,49,0,0,8,8,0.30028687059263703,0.20537916245557486
36,50,0,1,4,5,0.2558781513313358,0.175006121004876
36,51,0,0,2,2,0.6329208820818023,0.43288193188753926
36,52,1,0,5,6,1.05269799891663,0.7199856354341
36,53,2,0,7,9,3.263743249705773,2.232214994187773
36,54,0,0,9,9,0.7673134589281037,0.5247988206228559
36,55,2,1,8,11,0.9172239240441928,0.6273290634806433
36,56,0,0,3,3,0.15280599858190902,0.10451062327501487
36,57,1,0,8,9,1.117352375645636,0.764205556589774
36,58,2,1,9,12,1.083253529242707,0.7408838825481697
36,59,1,0,18,19,1.3842489548506445,0.9467476563865497
36,60,1,0,17,18,1.058763103381503,0.7241338223752833
36,61,1,0,16,17,1.0158040462272397,0.6947522674614399
36,62,1,0,15,16,0.6960856393326588,0.476083037934194
36,63,1,0,14,15,0.5535444261847499,0.3785929448310794
36,64,1,0,13,14,0.3621991406319041,0.24772363839384398
36,65,0,0,4,4,0.2835612235029497,0.19393976990395217
36,66,0,0,5,5,0.3461621075730094,0.2367552187243198
36,67,0,0,6,6,0.6216193290734915,0.4251523115857482
36,68,1,0,12,13,2.2790744828737295,1.5587574892725133
36,69,1,0,10,11,2.0526031296333476,1.4038639477836876
36,70,2,0,5,7,0.04837706189964385,0.03308716240374305
36,71,2,0,6,8,0.7374927036131632,0.5044031178793832
36,72,2,0,4,6,1.582017377720768,1.0820100238988704
36,73,2,0,4,6,2.218547519203381,1.5173604842017894
37,0,1,0,0,1,0.0008602583876544174,0.0005883678723720384
37,1,0,0,13,13,2.4856213333237194,1.7000238026132735
37,2,0,1,12,13,4.454507920960657,3.046630390976062
37,3,0,1,11,12,4.851539343247844,3.318177331463201
37,4,0,1,12,13,5.285396965015516,3.6149113005766575
37,5,0,0,16,16,1.3150632436798184,0.8994285598635664
37,6,0,0,15,15,2.3713331983566976,1.6218572101418403
37,7,0,0,14,14,0.9892294169211264,0.6765767305200963
37,8,0,0,9,9,7.940820627076583,5.431070250858081
37,9,0,0,8,8,12.83348552398936,8.777375124995913
37,10,0,0,7,7,11.727371625262267,8.020856048245406
37,11,0,0,5,5,0.11285171766510996,0.07718416462894662
37,12,0,0,6,6,0.008926429472407996,0.006105170716068148
37,13,0,1,26,27,0.41888239522099413,0.2864917647850778
37,14,0,1,5,6,0.3883734175183054,0.2656253570211026
37,15,0,2,12,14,10.74893082538393,7.351658118962702
37,16,0,1,6,7,0.03561154307965877,0.024356272643610795
37,17,0,1,25,26,0.8132198537986175,0.5561961871186131
37,18,0,1,30,31,1.6485622134747495,1.1275229116449241
37,19,0,1,31,32,2.651411686293021,1.813414986746131
37,20,0,1,28,29,1.834965810992415,1.255012384166081
37,21,0,1,29,30,1.409066309260902,0.9637213171166462
37,22,0,2,26,28,1.5737605352219954,1.0763628126385887
37,23,0,1,34,35,1.670563153550323,1.1425703049493299
37,24,0,1,33,34,1.5883486904644082,1.086340282181448
37,25,0,1,8,9,1.243974662113199,0.85080800807756
37,26,0,1,27,28,4.217079773805528,2.8842430248222812
37,27,0,2,14,16,1.2611961298815764,0.8625865138095776
37,28,0,0,3,3,1.7373799696659598,1.1882692118136051
37,29,0,1,10,11,1.95318107878676,1.3358649124206394
37,30,0,3,12,15,2.44596109830971,1.6728984546621857
37,31,0,0,1,1,0.045209491508965576,0.03092072418227613
37,32,0,1,7,8,1.7327155776849987,1.1850790326475176
37,33,0,2,8,10,2.003992503013221,1.3706170403781823
37,34,0,1,38,39,2.4342036114964216,1.6648570015359467
37,35,0,1,36,37,1.680861427628372,1.1496137394515225
37,36,0,2,15,17,2.6303560405740454,1.7990141210866035
37,38,0,1,13,14,2.2779953223425506,1.5580194047681484
37,39,0,1,32,33,1.1895057296088793,0.8135543522133909
37,40,0,1,9,10,1.8879035128592467,1.2912187652518594
37,41,0,1,12,13,2.625245035122234,1.7955184836751932
37,42,0,1,13,14,1.0340696301506973,0.7072448893351772
37,43,0,1,17,18,3.4247049876450015,2.3423036799172214
37,44,0,2,27,29,1.5658227999699617,1.0709338526090029
37,45,0,1,35,36,3.075785945685016,2.1036628746728363
37,46,0,1,15,16,3.083917863028213,2.109224644222759
37,47,0,0,4,4,1.8590478820562362,1.2714831528531105
37,48,0,1,37,38,2.90675420357484,1.9880547644864635
37,49,0,2,7,9,2.075834717750848,1.4197530344449478
37,50,0,3,13,16,2.2291023007622472,1.5245793552506077
37,51,0,2,13,15,2.5852889603029796,1.7681907981017435
37,52,0,1,11,12,2.711756674252878,1.8546875307675448
37,53,0,0,1,1,2.774,1.8972584300052115
37,54,0,2,6,8,3.031838968315473,2.0736056384480297
37,55,0,1,14,15,1.7640591329373987,1.2065162440494461
37,56,0,2,12,14,1.15161530071714,0.787639451120613
37,57,0,1,14,15,2.0477778562594273,1.400563734883273
37,58,0,1,15,16,1.969403146345224,1.3469598851774562
37,59,0,1,24,25,3.187700073752875,2.180205781274649
37,60,0,1,23,24,2.708414712319044,1.8524018186364264
37,61,0,1,22,23,3.0007339929046473,2.0523316021058187
37,62,0,1,21,22,2.5418044089426535,1.7384498350003112
37,63,0,1,20,21,2.814175379680883,1.9247361076469618
37,64,0,1,19,20,2.750394944969963,1.8811139131896117
37,65,0,2,11,13,2.7123171903035836,1.855070891907543
37,66,0,2,10,12,2.692301122020464,1.8413810381635962
37,67,0,2,9,11,2.5185914617874987,1.7225734976984426
37,68,0,1,18,19,3.3990481705345377,2.3247558743837216
37,69,0,1,16,17,3.6154899223793353,2.4727897382238937
37,70,0,0,11,11,0.24792824761263463,0.16956883843528858
37,71,0,0,12,12,2.8365398335015173,1.9400321237045177
37,72,0,0,10,10,2.8603862350354445,1.9563417078197065
37,73,0,0,2,2,8.957555088107371,6.126458869195308
38,0,2,0,0,2,0.0008343203745378831,0.000570627744743008
38,1,1,0,2,3,1.6624266370128788,1.1370053898117876
38,2,1,1,1,3,0.3695756085041795,0.25276872341703693
38,3,0,0,2,2,0.2678970410619231,0.18322635887822128
38,4,0,0,1,1,0.20315286864928686,0.1389450225755591
38,5,1,0,5,6,0.5772367339295337,0.39479713754739837
38,6,1,0,4,5,1.1701404103190767,0.8003095738167358
38,7,1,0,3,4,0.6226472705375053,0.4258553651575406
38,8,1,0,2,3,5.490882751291431,3.7554519062933944
38,9,1,0,3,4,9.374747938998313,6.411795081628887
38,10,1,0,4,5,8.771083641471803,5.998922991731502
38,11,1,0,6,7,0.11837176060574477,0.0809595604483807
38,12,1,0,5,6,0.004465557033142501,0.0030541873560918065
38,13,1,1,25,27,0.24725140118002878,0.16910591392192148
38,14,1,1,6,8,0.4716384634577012,0.32257391878508596
38,15,1,2,1,4,0.9147707666708396,0.6256512431826174
38,16,1,1,5,7,0.0024456306054391848,0.001672672416311551
38,17,1,1,24,26,0.6446708356116827,0.44091823267583596
38,18,1,1,29,31,1.1735552458707272,0.8026451273630409
38,19,1,1,30,32,2.027868282318057,1.3869467172199432
38,20,1,1,27,29,1.1632650128052358,0.7956071924566886
38,21,1,1,28,30,0.9520599750119442,0.6511549435695608
38,22,1,2,25,28,0.9184877533676863,0.6281934509493117
38,23,1,1,33,35,1.2098827171408437,0.8274910542224501
38,24,1,1,32,34,1.0916413204754778,0.7466206553042974
38,25,1,1,7,9,0.37717725536670677,0.25796781807884384
38,26,1,1,26,28,3.164511156215132,2.164345878866149
38,27,1,2,13,16,0.20571343197331543,0.14069630244292586
38,28,1,0,8,9,0.8264524126505703,0.5652465057315934
38,29,1,1,9,11,0.8771428571428571,0.5999158904229065
38,30,1,3,11,15,0.1313822085452297,0.08985796781367691
38,31,1,0,10,11,0.5425408458410953,0.371067120906336
38,32,1,1,6,8,0.38016778455682854,0.26001317017550396
38,33,1,2,7,10,0.28711489612976293,0.19637028012338262
38,34,1,1,37,39,1.9147938428015439,1.3096102234957834
38,35,1,1,35,37,0.8183490795799693,0.5597042862004695
38,36,1,2,14,17,0.5669540601720204,0.3877643727783157
38,37,1,0,11,12,1.4237470764640943,0.9737621279800928
38,39,1,1,31,33,0.7726598794638961,0.5284554685795557
38,40,1,1,8,10,0.7236481257136965,0.4949342130020843
38,41,1,1,11,13,1.4130481233665753,0.9664446517881322
38,42,1,1,12,14,0.6413333333333333,0.4386355706957495
38,43,1,1,16,18,2.588888888888889,1.7706529447697439
38,44,1,2,26,29,0.9417161976755695,0.6440803874233699
38,45,1,1,34,36,2.3819293382569056,1.6291043679468813
38,46,1,1,14,16,2.053030303030303,1.4041561101227094
38,47,1,0,7,8,0.8340751906219913,0.570460052871585
38,48,1,1,36,38,2.011717674028838,1.3759006185442284
38,49,1,2,6,9,0.14815771318984378,0.1013314601008383
38,50,1,3,12,16,0.19174674934958888,0.13114388487008066
38,51,1,2,12,15,0.3102002152702654,0.21215932711281268
38,52,1,1,10,12,1.3519285479701095,0.9246423339585419
38,53,1,0,12,13,3.7331573768058584,2.553267593252003
38,54,1,2,5,8,0.23044429948123843,0.1576108110444936
38,55,1,1,3,5,1.0859277345689553,0.7427128870899107
38,56,1,2,11,14,0.07764309754205227,0.053103468400640085
38,57,1,1,13,15,1.3282051282051281,0.9084168623876469
38,58,1,1,4,6,1.2692536462796176,0.8680973973391699
38,59,1,1,23,25,1.7531929804201216,1.1990844129517078
38,60,1,1,22,24,1.3778891986654183,0.9423979444055842
38,61,1,1,21,23,1.3739940806776592,0.9397339049541996
38,62,1,1,20,22,0.9993379308566388,0.6834903798636349
38,63,1,1,19,21,0.874695305003055,0.5982419037862386
38,64,1,1,18,20,0.6254661845559352,0.4277833422249256
38,65,1,2,10,13,0.4081648846029741,0.2791615963032073
38,66,1,2,9,12,0.2069643049734984,0.14155182852240064
38,67,1,2,8,11,0.19917364004528534,0.1362234562403537
38,68,1,1,17,19,2.592039525428593,1.7728078011990287
38,69,1,1,15,17,2.4265405193197394,1.6596158817695024
38,70,1,0,0,1,0.0012852517538002506,0.0008790391941515891
38,71,1,0,1,2,0.2225996000704642,0.15224548224566578
38,72,1,0,1,2,1.8570749728183324,1.2701337950004614
38,73,1,0,9,10,4.4326846053444315,3.0317044827123456
39,0,2,0,0,2,0.0005269296479955144,0.00036038994833423527
39,1,1,0,7,8,0.36441946404489467,0.2492422134885211
39,2,1,1,6,8,3.632297956558086,2.484285478864648
39,3,1,1,5,7,3.7982622833105,2.597795651183017
39,4,1,1,6,8,3.9191007200892334,2.680442278020473
39,5,1,0,10,11,0.3306487343710066,0.22614495265174706
39,6,1,0,9,10,0.43820946378890263,0.29971038186069177
39,7,1,0,8,9,0.10849161990040247,0.0742021054221196
39,8,1,0,3,4,1.3987745522184354,0.9566823398966083
39,9,1,0,2,3,3.037398705317056,2.0774081827504327
39,10,1,0,1,2,3.113614757839306,2.1295356334171807
39,11,1,0,1,2,0.05716895836708312,0.03910032018621681
39,12,1,0,0,1,0.0019061840556761672,0.0013037216181590238
39,13,0,0,6,6,0.03444418156947455,0.02355786367963797
39,14,1,1,1,3,0.2757499837392566,0.1885973256031379
39,15,1,2,6,9,8.726181868377488,5.968212729465686
39,16,0,0,26,26,0.027791155836638597,0.01900757198653609
39,17,0,0,7,7,0.2237052635986348,0.1530016932945378
39,18,0,0,2,2,0.2256869480283609,0.15435705287994078
39,19,0,0,1,1,0.601100918356965,0.4111188841516316
39,20,0,0,4,4,0.04814814814814815,0.032930598400581795
39,21,0,0,3,3,0.104559749824413,0.07151292962999405
39,22,0,1,6,7,0.13562839573037447,0.09276211865448299
39,23,0,0,2,2,0.22605126707723233,0.1546062264151545
39,24,0,0,1,1,0.1073118912976977,0.07339523806934387
39,25,0,0,24,24,0.5415213072630977,0.3703698144312741
39,26,0,0,5,5,0.9247115542313072,0.6324501772128943
39,27,0,1,34,35,1.1994955000014464,0.820386787718479
39,28,1,0,3,4,1.4088797802298152,0.9635937418546887
39,29,0,0,22,22,0.4888386904758281,0.33433789705045897
39,30,0,2,32,34,1.9005493083872125,1.2998677710808266
39,31,1,0,5,6,0.6694275702239422,0.457850432907455
39,32,0,0,25,25,0.9259651477753092,0.6333075639898078
39,33,0,1,28,29,1.2408667374644553,0.8486823641555521
39,34,0,0,6,6,0.5560177757447275,0.3802845754377907
39,35,0,0,4,4,0.5197525824020311,0.35548124314319823
39,36,0,1,35,36,1.8443812415941987,1.2614520038781805
39,37,1,0,6,7,1.6851331169459125,1.1525353323023038
39,38,1,1,7,9,1.751362393451498,1.1978323954469927
39,40,0,0,23,23,0.6333010361212538,0.4331419356568435
39,41,0,0,20,20,0.3476939664531418,0.2378029231849937
39,42,0,0,19,19,0.07086763875156434,0.04846943945060181
39,43,0,0,15,15,0.869739724244368,0.5948525680364222
39,44,0,1,7,8,0.12389434720247808,0.08473669598410026
39,45,0,0,3,3,0.694872345492762,0.4752532138657666
39,46,0,0,17,17,0.33641823198749266,0.2300909612998267
39,47,1,0,2,3,1.6529500668837858,1.1305239541358834
39,48,0,0,5,5,0.14718695594379277,0.10066751728592882
39,49,0,1,27,28,1.4451947616823002,0.9884311263882901
39,50,0,2,33,35,1.6219752699718846,1.1093389524924788
39,51,0,1,33,34,2.3523122526323537,1.608847963702697
39,52,0,0,21,21,0.49927832533953054,0.3414780143003998
39,53,1,0,7,8,2.4357109844971343,1.6658879590459557
39,54,0,1,26,27,2.547595756172952,1.7424107875431272
39,55,1,1,8,10,0.17929224270687216,0.12262570977294651
39,56,0,1,32,33,0.8679433414590398,0.5936239442502002
39,57,0,0,18,18,0.1814544206456834,0.12410451666609032
39,58,1,1,9,11,0.23612578319092634,0.16149662317972888
39,59,0,0,8,8,0.38732020392680006,0.26490501874962474
39,60,0,0,9,9,0.4836065287588694,0.33075939563566065
39,61,0,0,10,10,0.7460467933855881,0.5102536293904698
39,62,0,0,11,11,0.8516274523680839,0.5824648028944517
39,63,0,0,12,12,1.2377529020334983,0.8465526775942571
39,64,0,0,13,13,1.4856834995307922,1.0161231232171737
39,65,0,1,31,32,1.7031191490257107,1.1648367565942077
39,66,0,1,30,31,1.9075159417213055,1.3046325525595086
39,67,0,1,29,30,2.156132243161351,1.4746719807296034
39,68,0,0,14,14,0.879668096618044,0.6016430107841467
39,69,0,0,16,16,0.3847388148809793,0.26313949527150415
39,70,1,0,5,6,0.19074108115319632,0.13045606494816506
39,71,1,0,6,7,2.326883400605358,1.591456073337314
39,72,1,0,4,5,0.33306648027907854,0.22779855351897849
39,73,1,0,4,5,6.922714175047536,4.734743268610494
40,0,2,0,0,2,0.0005731867003841899,0.00039202714465420905
40,1,1,0,7,8,0.9209191864715134,0.6298564130809734
40,2,1,1,6,8,2.1001003521730888,1.4363493500422881
40,3,1,1,5,7,2.125216053403876,1.4535270630507964
40,4,1,1,6,8,2.0920684075764284,1.4308559561722989
40,5,1,0,10,11,0.11454804482696201,0.07834435605211557
40,6,1,0,9,10,0.3520182814388979,0.24076050900356744
40,7,1,0,8,9,0.3155172702754271,0.21579589071459512
40,8,1,0,3,4,3.1847551380374903,2.178191612524888
40,9,1,0,2,3,5.850590379885596,4.001471491977412
40,10,1,0,1,2,5.638083862069298,3.8561291046818007
40,11,1,0,1,2,0.0860527574914438,0.058855198116739685
40,12,1,0,0,1,0.0011270594377714067,0.0007708446356988952
40,13,0,0,17,17,0.09788047529160582,0.06694468524870799
40,14,1,1,1,3,0.3678207250689726,0.251568482829033
40,15,1,2,6,9,5.04510901765264,3.450567993524435
40,16,0,0,3,3,0.014668508324548593,0.010032426486788551
40,17,0,0,16,16,0.4186714630890217,0.2863474991882704
40,18,0,0,21,21,0.6619514918585175,0.45273721996506794
40,19,0,0,22,22,1.2605341252785405,0.8621337402645841
40,20,0,0,19,19,0.5395217106557079,0.36900220393380473
40,21,0,0,20,20,0.4937799015323729,0.33771740474024425
40,22,0,1,17,18,0.35891640761369625,0.24547843547666617
40,23,0,0,25,25,0.6845026200136531,0.46816091066386356
40,24,0,0,24,24,0.5675257733990785,0.3881553921509117
40,25,0,0,1,1,0.11411992263056092,0.07805154478816663
40,26,0,0,18,18,1.9504754025411686,1.334014383557693
40,27,0,1,11,12,0.7174528302889415,0.490696982839507
40,28,1,0,3,4,0.841421531647273,0.5754845328427128
40,29,0,0,1,1,0.15143530982312048,0.10357315002248246
40,30,0,2,9,11,1.0049573304927484,0.68733373001907
40,31,1,0,5,6,0.6010630075097073,0.41109295528553647
40,32,0,0,2,2,0.31955922865013775,0.2185603606497609
40,33,0,1,5,6,0.5322605083032852,0.3640359539788272
40,34,0,0,29,29,1.1928446126452372,0.8158379585535246
40,35,0,0,27,27,0.23005719229877392,0.157346051720324
40,36,0,1,12,13,0.8796251156024896,0.6016136142109344
40,37,1,0,6,7,1.5339216041981378,1.0491152467671359
40,38,1,1,7,9,0.9407425634278055,0.6434144769027096
40,39,0,0,23,23,0.36321677071660147,0.24841963956789553
40,41,0,0,3,3,0.4927569533135554,0.3370177662645376
40,42,0,0,4,4,0.30266740088016675,0.20700730995229386
40,43,0,0,8,8,1.6481491885140285,1.1272404260326205
40,44,0,1,18,19,0.3807122493653399,0.260385553177591
40,45,0,0,26,26,1.4803840683403473,1.0124986133035814
40,46,0,0,6,6,1.0909107349524647,0.7461209763056037
40,47,1,0,2,3,0.9971008321350677,0.6819603314107673
40,48,0,0,28,28,1.0202372273152944,0.6977843115101247
40,49,0,1,4,5,0.7070707070707071,0.4835962002882641
40,50,0,2,10,12,0.8081264290310267,0.5527125738965839
40,51,0,1,10,11,1.3888018797355601,0.9498615983905463
40,52,0,0,2,2,0.3750049309340507,0.2564820715602559
40,53,1,0,7,8,3.045112149002069,2.0826837400884863
40,54,0,1,3,4,1.4754922317750272,1.009152874961202
40,55,1,1,8,10,0.5303686246022195,0.36274201299092657
40,56,0,1,9,10,0.446646912059501,0.30548111721005217
40,57,0,0,5,5,0.6769242909857023,0.46297776407639674
40,58,1,1,9,11,0.665656121854489,0.4552709764502543
40,59,0,0,15,15,0.6212338698476753,0.4248886793703181
40,60,0,0,14,14,0.3883625889401311,0.26561795088872114
40,61,0,0,13,13,0.24632583909346992,0.16847288202890884
40,62,0,0,12,12,0.05305889729377392,0.03628927187360969
40,63,0,0,11,11,0.2680245012882523,0.1833135344329774
40,64,0,0,10,10,0.5147013604350327,0.3520264942395518
40,65,0,1,8,9,0.732394610461924,0.5009163117481141
40,66,0,1,7,8,0.9372076499950178,0.6409967969064244
40,67,0,1,6,7,1.2512649849252555,0.8557941747728135
40,68,0,0,9,9,1.6583174893683603,1.134194966232588
40,69,0,0,7,7,1.2928443480523153,0.8842320973420502
40,70,1,0,5,6,0.1027731081416276,0.07029096820459271
40,71,1,0,6,7,1.3437907860445253,0.9190765670462527
40,72,1,0,4,5,0.9760743378657813,0.6675794036869535
40,73,1,0,4,5,4.144636106859718,2.8346956716090776
41,0,2,0,0,2,0.0005672876480820054,0.000387992527960135
41,1,1,0,7,8,0.5251774564474144,0.3591915488441066
41,2,1,1,6,8,3.0423899602984315,2.0808219176421847
41,3,1,1,5,7,3.1527578042514044,2.15630725374214
41,4,1,1,6,8,3.2124876934426467,2.1971591051449386
41,5,1,0,10,11,0.15578064347656964,0.1065451114158465
41,6,1,0,9,10,0.12701819897414643,0.08687323315348905
41,7,1,0,8,9,0.1522611935930497,0.10413800760889294
41,8,1,0,3,4,1.9526311979074087,1.335488825133744
41,9,1,0,2,3,3.9660135044253133,2.712527957745291
41,10,1,0,1,2,3.9621792617652276,2.7099055535601675
41,11,1,0,1,2,0.07093499910161136,0.048515510103801104
41,12,1,0,0,1,0.000952079462200636,0.0006511682716997061
41,13,0,0,14,14,0.027871511353436084,0.019062530595635393
41,14,1,1,1,3,0.32253236645889327,0.2205938180294396
41,15,1,2,6,9,7.305030610628694,4.9962259940379985
41,16,0,0,6,6,0.022966904421991324,0.015708058048214495
41,17,0,0,13,13,0.298185212975501,0.20394174802475437
41,18,0,0,18,18,0.38975896370813295,0.2665729919125272
41,19,0,0,19,19,0.8515367192351091,0.5824027465853612
41,20,0,0,16,16,0.21415038439402181,0.14646669865912562
41,21,0,0,17,17,0.2513240118386942,0.17189134827818747
41,22,0,1,14,15,0.08999314102807372,0.06155019663235787
41,23,0,0,22,22,0.4073769092383067,0.2786226659127056
41,24,0,0,21,21,0.29460020284088206,0.201489804730032
41,25,0,0,4,4,0.37717725536670677,0.25796781807884384
41,26,0,0,15,15,1.3015167614594452,0.8901635354982026
41,27,0,1,14,15,1.0276581404502674,0.7028597945684029
41,28,1,0,3,4,1.2252287095484824,0.8379868413393169
41,29,0,0,2,2,0.237160068222253,0.16220401539123308
41,30,0,2,12,14,1.569242397269743,1.0732726629205505
41,31,1,0,5,6,0.6619250817040083,0.4527191569195452
41,32,0,0,5,5,0.6942162425103522,0.4748044766940547
41,33,0,1,8,9,0.9709677419354839,0.6640867821377872
41,34,0,0,26,26,0.8123243532004218,0.5555837155760747
41,35,0,0,24,24,0.36362904208398095,0.2487016097651596
41,36,0,1,15,16,1.5015317313328094,1.0269624135513675
41,37,1,0,6,7,1.6772398835503164,1.147136809014707
41,38,1,1,7,9,1.4444491927747214,0.9879211996056463
41,39,0,0,20,20,0.15680316134161296,0.10724445555401677
41,40,0,0,3,3,0.38746700602433415,0.2650054230456193
41,42,0,0,1,1,0.12134065911950355,0.08299011839108394
41,43,0,0,5,5,1.144450437476817,0.7827390916460141
41,44,0,1,15,16,0.1299492949256906,0.08887793629091563
41,45,0,0,23,23,1.002002141123624,0.6853125483525837
41,46,0,0,3,3,0.5757700357503438,0.3937939993048817
41,47,1,0,2,3,1.4409454482117712,0.9855248373458619
41,48,0,0,25,25,0.529648940336899,0.3622497898332765
41,49,0,1,7,8,1.1649843813854805,0.7967831429012292
41,50,0,2,13,15,1.3207073724819556,0.903288823363887
41,51,0,1,13,14,2.00158124475097,1.368967876692178
41,52,0,0,1,1,0.14807692307692308,0.10127620425267685
41,53,1,0,7,8,2.7620282402611305,1.8890704263691025
41,54,0,1,6,7,2.142156862745098,1.465113614360726
41,55,1,1,8,10,0.23563338822034155,0.1611598529890893
41,56,0,1,12,13,0.7120779303238423,0.4870208565708628
41,57,0,0,2,2,0.32821514407794145,0.22448051512518008
41,58,1,1,9,11,0.34406409583218117,0.2353202978657991
41,59,0,0,12,12,0.06348867255949953,0.04342264571858365
41,60,0,0,11,11,0.1563598246845737,0.10694123846320996
41,61,0,0,10,10,0.3735689638166437,0.2554999516183991
41,62,0,0,9,9,0.5282291467669505,0.36127873167918423
41,63,0,0,8,8,0.8705500227761828,0.5954067662052421
41,64,0,0,7,7,1.1200487167395434,0.7660497007392278
41,65,0,1,11,12,1.3385135422811,0.9154672320724421
41,66,0,1,10,11,1.5436764756720778,1.055787024754717
41,67,0,1,9,10,1.8176029697256648,1.2431371869915373
41,68,0,0,6,6,1.1584616578159839,0.7923219704863692
41,69,0,0,4,4,0.6861978914549686,0.469320380034153
41,70,1,0,5,6,0.15736767157264303,0.10763054848647748
41,71,1,0,6,7,1.950138022080954,1.3337836344869427
41,72,1,0,4,5,0.5056138597713686,0.3458111599779027
41,73,1,0,4,5,6.02322335057813,4.1195426379555125
42,0,2,0,0,2,0.0006231751064907233,0.0004262163749671666
42,1,1,0,7,8,0.2646804557341136,0.1810263972239251
42,2,1,1,6,8,3.673921235071915,2.512753437063933
42,3,1,1,5,7,3.8416075809801633,2.6274413726699866
42,4,1,1,6,8,3.96385253306679,2.7110499760845275
42,5,1,0,10,11,0.3210411504080659,0.21957391095539802
42,6,1,0,9,10,0.40307496811477717,0.27568038254500465
42,7,1,0,8,9,0.050361411904344795,0.03444434509101765
42,8,1,0,3,4,1.135690709845666,0.7767479355202926
42,9,1,0,2,3,2.71073611363736,1.8539895252768734
42,10,1,0,1,2,2.8446343922346013,1.9455683420871843
42,11,1,0,1,2,0.06225438415924353,0.04257846256341301
42,12,1,0,0,1,0.002096688807987096,0.0014340160476031347
42,13,0,0,13,13,0.04655241419704993,0.03183920701962771
42,14,1,1,1,3,0.297813189243463,0.20368730492389964
42,15,1,2,6,9,8.820249744511521,6.032549813455586
42,16,0,0,7,7,0.02853204096766733,0.019514295332069536
42,17,0,0,12,12,0.21791796940662356,0.14904351279968794
42,18,0,0,17,17,0.21050126986271347,0.1439709115983544
42,19,0,0,18,18,0.5794855385942371,0.3963351922004422
42,20,0,0,15,15,0.08471870846566797,0.05794278436036136
42,21,0,0,16,16,0.09891453653913747,0.06765192440480788
42,22,0,1,13,14,0.1699673171197595,0.11624799034997578
42,23,0,0,21,21,0.22923531168866634,0.15678393206784225
42,24,0,0,20,20,0.13567683341307754,0.09279524727807287
42,25,0,0,5,5,0.5531923347439132,0.37835213428520337
42,26,0,0,14,14,0.8679464083096523,0.5936260418018144
42,27,0,1,15,16,1.2366999906361502,0.8458325460064176
42,28,1,0,3,4,1.5258533502407405,1.0435970193568636
42,29,0,0,3,3,0.49714285714285716,0.3400174753536994
42,30,0,2,13,15,1.9472481027365545,1.331807093809871
42,31,1,0,5,6,0.7100740384235226,0.48565030833701256
42,32,0,0,6,6,0.9449045852101744,0.646261063388818
42,33,0,1,9,10,1.2645202435746095,0.8648600187578123
42,34,0,0,25,25,0.5641046861837802,0.3858155628217813
42,35,0,0,23,23,0.5857390867765082,0.40061226394026106
42,36,0,1,16,17,1.9294437427489444,1.319629922909604
42,37,1,0,6,7,1.7952597745671828,1.2278557106513495
42,38,1,1,7,9,1.7814814814814814,1.2184321408215262
42,39,0,0,19,19,0.08684759650927001,0.05939882285612968
42,40,0,0,4,4,0.6467252155559119,0.4423233118638758
42,41,0,0,1,1,0.3297300519551727,0.2255166260627281
42,43,0,0,4,4,0.8074074074074075,0.5522208039482177
42,44,0,1,14,15,0.18785728073591682,0.1284837092696733
42,45,0,0,22,22,0.686246538224048,0.4693536516609476
42,46,0,0,2,2,0.23106060606060605,0.15803232973705772
42,47,1,0,2,3,1.7750452361215412,1.214030114589829
42,48,0,0,24,24,0.3145790838565082,0.21515422449534122
42,49,0,1,8,9,1.471381434481806,1.006341323115994
42,50,0,2,14,16,1.664247986731749,1.1382510895623692
42,51,0,1,14,15,2.4125757385447772,1.6500647649531823
42,52,0,0,2,2,0.49809177287040524,0.34066647981060477
42,53,1,0,7,8,2.6140114766389226,1.7878353677662462
42,54,0,1,7,8,2.588239936121803,1.7702090979391638
42,55,1,1,8,10,0.06424540383899234,0.04394020692956647
42,56,0,1,13,14,0.8899304259402671,0.6086618611151047
42,57,0,0,1,1,0.09487179487179487,0.06488691874197478
42,58,1,1,9,11,0.13630302542214176,0.09322352704303284
42,59,0,0,11,11,0.39932904705127276,0.27311838531505944
42,60,0,0,10,10,0.5045152872300582,0.34505979876125764
42,61,0,0,9,9,0.7767247769611885,0.5312356275715691
42,62,0,0,8,8,0.8823219219065982,0.603458076537741
42,63,0,0,7,7,1.2758741907311941,0.8726254736809067
42,64,0,0,6,6,1.525657804452973,1.0434632771455103
42,65,0,1,12,13,1.744269327336884,1.1929811411281264
42,66,0,1,11,12,1.9495247429907532,1.3333641864249999
42,67,0,1,10,11,2.1965013215465077,1.502282137282516
42,68,0,0,5,5,0.8239314276108445,0.5635222951625464
42,69,0,0,3,3,0.2807624032960821,0.19202553586229804
42,70,1,0,5,6,0.1939006302432608,0.1326170170556417
42,71,1,0,6,7,2.3562813377578276,1.6115625924747639
42,72,1,0,4,5,0.19713081068179505,0.13482627699343802
42,73,1,0,4,5,7.5378641793286105,5.155470929511724
43,0,2,0,0,2,0.0008908026486376258,0.0006092584118957123
43,1,1,0,7,8,0.38995369328183244,0.26670617587982093
43,2,1,1,6,8,5.18670625527891,3.5474124609908713
43,3,1,1,5,7,5.491773733682507,3.756061287638908
43,4,1,1,6,8,5.763888119698652,3.942172070910294
43,5,1,0,10,11,0.7233795735585867,0.4947505385824094
43,6,1,0,9,10,1.1053776345486481,0.75601551387406
43,7,1,0,8,9,0.22773125462757982,0.15575524247218428
43,8,1,0,3,4,0.896296327917289,0.6130157764685623
43,9,1,0,2,3,0.49114457528019234,0.33591499127673907
43,10,1,0,1,2,0.34285664387651393,0.2344944693143514
43,11,1,0,1,2,0.05114878945304393,0.03498286660935445
43,12,1,0,0,1,0.005001770929999436,0.0034209272032791767
43,13,0,0,9,9,0.1715592466565958,0.11733677972767477
43,14,1,1,1,3,0.26855215427841955,0.18367441910626953
43,15,1,2,6,9,12.450105979022386,8.515165293135727
43,16,0,0,11,11,0.04190013308308794,0.02865731099864054
43,17,0,0,8,8,0.04614655074226202,0.031561619470591155
43,18,0,0,13,13,0.24920852163680599,0.17044447314512123
43,19,0,0,14,14,0.1533524961076363,0.10488439654021425
43,20,0,0,11,11,0.5710980874188225,0.3905986520242301
43,21,0,0,12,12,0.32172632865574513,0.22004253395700782
43,22,0,1,9,10,0.6419799619964305,0.4390778279712159
43,23,0,0,17,17,0.2726004051772077,0.18644319277047353
43,24,0,0,16,16,0.38475308866351043,0.26314925772796965
43,25,0,0,9,9,0.9748554120228472,0.66674572764836
43,26,0,0,10,10,0.21129968867704826,0.14451698471521504
43,27,0,1,19,20,1.7410906170102958,1.1908070838232727
43,28,1,0,3,4,2.304518077628787,1.5761594628264672
43,29,0,0,7,7,1.12,0.7660163812566102
43,30,0,2,17,19,2.8544685059374695,1.9522943172581995
43,31,1,0,5,6,0.8465039540903225,0.5789606210997149
43,32,0,0,10,10,1.5454551592737054,1.0570035433046447
43,33,0,1,13,14,1.9677445795857433,1.3458255197246258
43,34,0,0,21,21,0.24289684435636968,0.1661276444040325
43,35,0,0,19,19,1.1708341571105576,0.8007840572155919
43,36,0,1,20,21,2.9699430533368725,2.0312723484422492
43,37,1,0,6,7,2.140440617278126,1.4639397999482635
43,38,1,1,7,9,2.588888888888889,1.7706529447697439
43,39,0,0,15,15,0.38370870187251527,0.2624349564866569
43,40,0,0,8,8,1.2678070680877143,0.8671080200250927
43,41,0,0,5,5,1.1195710801403644,0.765723024436318
43,42,0,0,4,4,0.2906666666666667,0.19879948942135836
43,44,0,1,10,11,0.649871376334388,0.44447510712671484
43,45,0,0,18,18,0.2379560605126373,0.1627484289035441
43,46,0,0,2,2,0.5946969696969697,0.40673894702816493
43,47,1,0,2,3,2.6285004768773477,1.7977450209186252
43,48,0,0,20,20,0.8647126690409941,0.5914143478263636
43,49,0,1,12,13,2.205387847945006,1.5083600165626228
43,50,0,2,18,20,2.4889231765909394,1.7022820758552666
43,51,0,1,18,19,3.4004838316416386,2.325737785031911
43,52,0,0,6,6,1.3365439955613156,0.9141201739911875
43,53,1,0,7,8,2.4600292681185723,1.6825202837049433
43,54,0,1,11,12,3.6568660305930676,2.501088645977791
43,55,1,1,8,10,0.4520749692857641,0.3091936000258698
43,56,0,1,17,18,1.3168312717396444,0.9006377906281627
43,57,0,0,3,3,0.4641025641025641,0.3174197916837144
43,58,1,1,9,11,0.4008724187882284,0.27417396391584203
43,59,0,0,7,7,1.3695337921047572,0.9366833209256509
43,60,0,0,6,6,1.3544678964341321,0.9263791040667206
43,61,0,0,5,5,1.7487311476022802,1.1960327727473374
43,62,0,0,4,4,1.733165972528332,1.1853870771368273
43,63,0,0,3,3,2.2485169520680173,1.537857873944005
43,64,0,0,2,2,2.498441996987057,1.7087924083138966
43,65,0,1,16,17,2.7171377242069776,1.8583678632793308
43,66,0,1,15,16,2.9224513100747553,1.998790693698307
43,67,0,1,14,15,3.10463922577523,2.123396879317559
43,68,0,0,1,1,0.033895384034165026,0.023182517338530516
43,69,0,0,1,1,0.6948994487991241,0.47527175098778407
43,70,1,0,5,6,0.2814148767174173,0.19247179062040276
43,71,1,0,6,7,3.3290949650067305,2.276911855316123
43,72,1,0,4,5,0.574977878835083,0.3932522089712964
43,73,1,0,4,5,11.500083579590301,7.865403935523506
44,0,3,0,0,3,0.00048492198450311675,0.0003316590926436175
44,1,2,0,7,9,0.49952099075465023,0.34164398366035165
44,2,2,1,6,9,3.2537612524290473,2.2253878750523888
44,3,2,1,5,8,3.3857831174841895,2.315683331584789
44,4,2,1,6,9,3.469787738711253,2.3731377208358486
44,5,2,0,10,12,0.24212213610645988,0.16559778796642044
44,6,2,0,9,11,0.3068568312082473,0.20987264232679653
44,7,2,0,8,10,0.15144361947808968,0.10357883335447263
44,8,2,0,3,5,1.8459806683980127,1.262545920960629
44,9,2,0,2,4,3.757515616881866,2.569927245856292
44,10,2,0,1,3,3.762440625099589,2.573295671724684
44,11,2,0,1,3,0.06288026366483265,0.043006528593746984
44,12,2,0,0,2,0.0011708520375396593,0.0008007962864134451
44,13,1,0,0,1,0.006903222324251905,0.004721411949851153
44,14,2,1,1,4,0.2918350933351417,0.1995986268930985
44,15,2,2,6,10,7.8185765257423245,5.347462229309835
44,16,1,0,20,21,0.024411825907356657,0.016696302269124743
44,17,1,0,1,2,0.27279123701531716,0.1865737109080246
44,18,1,0,4,5,0.33542198400878886,0.22940958427171879
44,19,1,0,5,6,0.7673909622147559,0.5248518284685495
44,20,1,0,2,3,0.14327903821654192,0.09799472353978841
44,21,1,0,3,4,0.2010318667193661,0.1374943777335982
44,22,0,0,1,1,0.040551750201988125,0.027735093699418713
44,23,1,0,8,9,0.340625,0.23296815166565435
44,24,1,0,7,8,0.221875,0.15174989695652716
44,25,1,0,18,19,0.4370356859624961,0.29890758450088534
44,26,1,0,1,2,1.1849062766942144,0.8104085876799516
44,27,1,1,28,30,1.0715799245260107,0.7328998000112914
44,28,2,0,3,5,1.2142103393918773,0.8304509020226128
44,29,1,0,16,17,0.3412462154981894,0.23339302777985396
44,30,1,2,26,29,1.6714995035230422,1.1432107151436979
44,31,2,0,5,7,0.6386784215805906,0.43681976186236415
44,32,1,0,19,20,0.7761619379549499,0.530850677661936
44,33,1,1,22,24,1.0649070640909866,0.7283359425085523
44,34,1,0,12,13,0.7133964322498647,0.48792263699412314
44,35,1,0,10,11,0.3693556702030051,0.2526182981120678
44,36,1,1,29,31,1.5796898313043377,1.0804181143603695
44,37,2,0,6,8,1.609317877746905,1.1006820151814751
44,38,2,1,7,10,1.5485999695109365,1.059154414873986
44,39,1,0,6,7,0.08988413424493508,0.06147564218454333
44,40,1,0,17,18,0.48158472569290867,0.32937659718191
44,41,1,0,14,15,0.209048865750024,0.142977549685386
44,42,1,0,13,14,0.11121151019566275,0.07606235588764661
44,43,1,0,9,10,1.0686773744165492,0.7309146206083754
44,45,1,0,9,10,0.8913290495040516,0.6096184401874889
44,46,1,0,11,12,0.5183999629431224,0.35455612826540306
44,47,2,0,2,4,1.43878716526957,0.984048694409154
44,48,1,0,11,12,0.3440930106817051,0.23534007398043919
44,49,1,1,21,23,1.2611360453876137,0.8625454194286536
44,50,1,2,27,30,1.4137899206929847,0.9669519990234913
44,51,1,1,27,29,2.102292383200493,1.4378485747523007
44,52,1,0,15,16,0.3156717735861939,0.21590156220299309
44,53,2,0,7,9,2.53129216014272,1.7312600539426382
44,54,1,1,20,22,2.27900586729734,1.5587105601157956
44,55,2,1,8,11,0.2427112497793778,0.16600070825559665
44,56,1,1,26,28,0.7601624707455813,0.5199079508996555
44,57,1,0,12,13,0.2947045233475816,0.20156115403095423
44,58,2,1,9,12,0.3331823637714708,0.22787781124530856
44,59,1,0,2,3,0.19715015595313878,0.13483950806017833
44,60,1,0,3,4,0.2857242310019236,0.19541914416912617
44,61,1,0,4,5,0.5090117804784249,0.34813514473131
44,62,1,0,5,6,0.6404850504527921,0.4380553933900047
44,63,1,0,6,7,0.994486654989161,0.6801723827346324
44,64,1,0,7,8,1.241555099097252,0.8491531644117583
44,65,1,1,25,27,1.4585597567787165,0.9975720238697805
44,66,1,1,24,26,1.6626947316711629,1.1371887513296206
44,67,1,1,23,25,1.9273479548044479,1.3181965230014572
44,68,1,0,8,9,1.0783784523557536,0.737549606873802
44,69,1,0,10,11,0.606358638751247,0.41471486624992365
44,70,2,0,5,7,0.1687747678884288,0.11543235441546301
44,71,2,0,6,8,2.0831681747884714,1.4247687025003595
44,72,2,0,4,6,0.4808777069277196,0.32889303650691837
44,73,2,0,4,6,5.935292822117144,4.059403151157596
45,0,2,0,0,2,0.0007739527055690873,0.000529339688199817
45,1,1,0,7,8,0.37027577790722155,0.25324759951738046
45,2,1,1,6,8,4.976337721075363,3.4035323330436755
45,3,1,1,5,7,5.263610249669177,3.6000104248185587
45,4,1,1,6,8,5.516480948192645,3.7729596189335393
45,5,1,0,10,11,0.675697923317343,0.4621389982519265
45,6,1,0,9,10,1.0258468707165218,0.7016209889550783
45,7,1,0,8,9,0.20968120452211234,0.1434100334871033
45,8,1,0,3,4,0.9254549919627428,0.6329586463921121
45,9,1,0,2,3,1.1542201485135182,0.7894210190516006
45,10,1,0,1,2,1.1631503610384097,0.7955287771606807
45,11,1,0,1,2,0.043444368156764085,0.0297134800727003
45,12,1,0,0,1,0.004523259983146135,0.0030936528962253913
45,13,0,0,9,9,0.14976745248638984,0.10243243034254076
45,14,1,1,1,3,0.2396022497018835,0.16387432880141029
45,15,1,2,6,9,11.949944792991953,8.1730834522714
45,16,0,0,29,29,0.039745462558666664,0.02718363875049994
45,17,0,0,10,10,0.05079093804759962,0.03473811657486692
45,18,0,0,5,5,0.17773759876541723,0.12156242162457523
45,19,0,0,4,4,0.052595621083969035,0.03597241726132664
45,20,0,0,7,7,0.48404194149668156,0.3310571932158141
45,21,0,0,6,6,0.25732291166035803,0.17599425500400162
45,22,0,1,9,10,0.5636400655176939,0.3854977886777701
45,23,0,0,1,1,0.17960218385210253,0.12283769191086784
45,24,0,0,2,2,0.29817878911448037,0.20393735446870728
45,25,0,0,27,27,0.9149089517445869,0.6257457539238099
45,26,0,0,8,8,0.165919051525356,0.1134792066348056
45,27,0,1,37,38,1.6521405543677548,1.129970293557212
45,28,1,0,3,4,2.1208912536088045,1.4505691456501892
45,29,0,0,25,25,1.0343301095444355,0.7074230424446265
45,30,0,2,35,37,2.7110275061107165,1.8541888211768427
45,31,1,0,5,6,0.7914965555680874,0.5413386850654803
45,32,0,0,28,28,1.4590372771274476,0.9978986206639869
45,33,0,1,31,32,1.8658557805909382,1.2761393687455342
45,34,0,0,3,3,0.05506829855384138,0.03766358819658232
45,35,0,0,1,1,1.0569444444444445,0.7228899629666176
45,36,0,1,38,39,2.7817887445978093,1.9025854888903417
45,37,1,0,6,7,1.9935649647958438,1.3634851965472088
45,38,1,1,7,9,2.4701489433775317,1.6894415667597287
45,39,0,0,3,3,0.31791545218623096,0.2174361109189782
45,40,0,0,26,26,1.1809331599296218,0.8076912014957345
45,41,0,0,23,23,1.0165239112848359,0.695244614270737
45,42,0,0,22,22,0.2561987076036446,0.17522536328675378
45,43,0,0,18,18,0.24676924793903127,0.16877614849256423
45,44,0,1,10,11,0.5620994005881406,0.38444406137949755
45,46,0,0,20,20,0.5117878431272269,0.35003381389593224
45,47,1,0,2,3,2.431138422175459,1.6627605861506698
45,48,0,0,2,2,0.6747592163134936,0.46149697598215056
45,49,0,1,30,31,2.0981767241215,1.4350336977217863
45,50,0,2,36,38,2.3587089580544363,1.613222946862865
45,51,0,1,36,37,3.236567920008237,2.21362861229995
45,52,0,0,24,24,1.2243401797456641,0.8373791374248585
45,53,1,0,7,8,2.2370346443450533,1.530004627684702
45,54,0,1,29,30,3.4993142418763554,2.3933321718230753
45,55,1,1,8,10,0.41486800142050845,0.2837461474529466
45,56,0,1,35,36,1.2493339248058928,0.8544734393401142
45,57,0,0,21,21,0.4030721112781233,0.2756784286310087
45,58,1,1,9,11,0.36999111345582497,0.2530529052022634
45,59,0,0,11,11,1.23007072137818,0.8412985023926979
45,60,0,0,12,12,1.2308097245817486,0.8418039386067466
45,61,0,0,13,13,1.6058092184856425,1.098282291547212
45,62,0,0,14,14,1.6068747645006636,1.0990110644958626
45,63,0,0,15,15,2.1029439474635243,1.438294207697768
45,64,0,0,16,16,2.351966888834422,1.6086117544824217
45,65,0,1,34,35,2.570017594039673,1.7577460510286522
45,66,0,1,33,34,2.774818434950074,1.8978181930219524
45,67,0,1,32,33,2.9660879878029394,2.028635702594204
45,68,0,0,17,17,0.23656167080001675,0.16179474554486284
45,69,0,0,19,19,0.5844805440539069,0.39975149220631123
45,70,1,0,5,6,0.26862729063053725,0.1837258081031892
45,71,1,0,6,7,3.191717647814002,2.182953573724413
45,72,1,0,4,5,0.5228664023355852,0.35761091910514986
45,73,1,0,4,5,10.552235459968395,7.2171296617970295
46,0,2,0,0,2,0.000683734480693216,0.00046763554700087953
46,1,1,0,7,8,0.1054660163559733,0.07213276445942245
46,2,1,1,6,8,4.09714130098997,2.8022119222154798
46,3,1,1,5,7,4.3032470335944675,2.9431765360064968
46,4,1,1,6,8,4.467400837299442,3.0554484134025617
46,5,1,0,10,11,0.4332255383179977,0.29630165993776747
46,6,1,0,9,10,0.5982886216126986,0.4091954329238971
46,7,1,0,8,9,0.04761723727373422,0.032567485519520774
46,8,1,0,3,4,0.6018223015514033,0.411612269280295
46,9,1,0,2,3,1.8740481122854058,1.2817424582800432
46,10,1,0,1,2,2.097830220101978,1.4347967086547104
46,11,1,0,1,2,0.057564149871625066,0.03937060872747804
46,12,1,0,0,1,0.002903022186442064,0.001985502276755359
46,13,0,0,11,11,0.0800202373071013,0.05472929697257226
46,14,1,1,1,3,0.28510912872969196,0.19499844915423542
46,15,1,2,6,9,9.835684747105535,6.727049676034482
46,16,0,0,9,9,0.03227042408238734,0.022071137033220105
46,17,0,0,10,10,0.16480713546600523,0.11271871920976542
46,18,0,0,15,15,0.1010151513888952,0.06908862564197335
46,19,0,0,16,16,0.4005964332038968,0.27398520545281646
46,20,0,0,13,13,0.19505000746157522,0.1334031257855274
46,21,0,0,14,14,0.06766856049137594,0.04628145163611413
46,22,0,1,11,12,0.2980512840120548,0.20385014822125033
46,23,0,0,19,19,0.1306575584091653,0.0893623482825116
46,24,0,0,18,18,0.11451228858123093,0.07831990081107783
46,25,0,0,7,7,0.6711805807163649,0.45904939250898213
46,26,0,0,12,12,0.5794661363549742,0.39632192217088114
46,27,0,1,17,18,1.3775577903838678,0.942171279965806
46,28,1,0,3,4,1.7384516525787148,1.1890021820517152
46,29,0,0,5,5,0.6714285714285714,0.45921900406965155
46,30,0,2,15,17,2.2010108552031773,1.5053664021511202
46,31,1,0,5,6,0.7458276267855578,0.5101037318852489
46,32,0,0,8,8,1.1129485107598405,0.7611935631582023
46,33,0,1,11,12,1.4612938830690798,0.9994420109473184
46,34,0,0,23,23,0.40816737711643003,0.27916330104083026
46,35,0,0,21,21,0.7461759506863752,0.5103419656477571
46,36,0,1,18,19,2.219391444223554,1.5179376809785794
46,37,1,0,6,7,1.8846164718505747,1.2889706159139085
46,38,1,1,7,9,2.0074074074074075,1.3729526410088715
46,39,0,0,17,17,0.14512159026911448,0.0992549244822782
46,40,0,0,6,6,0.8205140570582641,0.5611850078195993
46,41,0,0,3,3,0.5507365559351115,0.37667252107423466
46,42,0,0,2,2,0.08133333333333333,0.05562738006744432
46,43,0,0,2,2,0.5814814814814815,0.3977003037608724
46,44,0,1,12,13,0.3082378158040187,0.21081715734699644
46,45,0,0,20,20,0.4825428235199568,0.33003188167330755
46,47,1,0,2,3,2.0090128950556787,1.3740507033646583
46,48,0,0,22,22,0.35674080226405275,0.24399044499722292
46,49,0,1,10,11,1.676768521898831,1.1468144244195875
46,50,0,2,16,18,1.8949107357631811,1.2960113076907258
46,51,0,1,16,17,2.6887862096105253,1.8389770377308319
46,52,0,0,4,4,0.7327024025147506,0.501126824028905
46,53,1,0,7,8,2.5418890613085376,1.7385077324101144
46,54,0,1,9,10,2.887259063214818,1.9747211958519335
46,55,1,1,8,10,0.11875055685019527,0.08121863556303031
46,56,0,1,15,16,1.009337413657973,0.690329458104631
46,57,0,0,1,1,0.06153846153846154,0.04208881215695662
46,58,1,1,9,11,0.06367656723960158,0.04355115500689539
46,59,0,0,9,9,0.669929254232132,0.4581935562721763
46,60,0,0,8,8,0.7419741675309208,0.5074681846410016
46,61,0,0,7,7,1.0484824317830286,0.7171024269692556
46,62,0,0,6,6,1.1202921377377213,0.7662161868750726
46,63,0,0,5,5,1.5479633102104366,1.058718976076252
46,64,0,0,4,4,1.7978119784220075,1.2296012731166188
46,65,0,1,14,15,2.0164603355279898,1.3791443296148582
46,66,0,1,13,14,2.221740269028529,1.5195441437261799
46,67,0,1,12,13,2.450598708025812,1.6760703162804078
46,68,0,0,3,3,0.5998170496739691,0.4102407908993485
46,69,0,0,1,1,0.031959422016241856,0.021858429285655737
46,70,1,0,5,6,0.2183884963689138,0.1493653265148105
46,71,1,0,6,7,2.6284607668500395,1.7977178615155731
46,72,1,0,4,5,0.07092603547158158,0.04850937949001688
46,73,1,0,4,5,8.616531637197479,5.893218199740276
47,0,1,0,0,1,0.0004980101548902451,0.0003406106577482764
47,1,0,0,9,9,1.5079167359626842,1.031329394034299
47,2,0,1,8,9,1.7050272888008435,1.1661418158133854
47,3,0,1,7,8,1.7728446283351262,1.2125250238638337
47,4,0,1,8,9,1.8289407445233605,1.2508915809397814
47,5,0,0,12,12,0.5512561728958963,0.3770279095598954
47,6,0,0,11,11,1.0854175808618485,0.7423639709322297
47,7,0,0,10,10,0.5651559834090972,0.38653459040764065
47,8,0,0,5,5,4.985120421798726,3.4095392014595416
47,9,0,0,4,4,8.545530404367847,5.844657389528747
47,10,0,0,3,3,8.01118045893856,5.47919237924088
47,11,0,0,1,1,0.09623758870405079,0.0658210441428027
47,12,0,0,2,2,0.003707784154228379,0.0025359137502702005
47,13,0,1,22,23,0.20731575467674473,0.14179220015621716
47,14,0,1,1,2,0.3794297465847444,0.259508394124963
47,15,0,2,8,10,4.139956051833293,2.8314947798095917
47,16,0,1,2,3,0.009854522619847558,0.006739933710952711
47,17,0,1,21,22,0.5717277397663746,0.39102929846416007
47,18,0,1,26,27,1.0252649648446714,0.7012229983924116
47,19,0,1,27,28,1.7897249071694,1.2240701757452914
47,20,0,1,24,25,0.9957461727175424,0.6810338213171532
47,21,0,1,25,26,0.8232235684723201,0.5630381597199285
47,22,0,2,22,24,0.7767556776207363,0.5312567618674666
47,23,0,1,30,31,1.0439578967936292,0.7140079020411764
47,24,0,1,29,30,0.9295029286906223,0.6357272051812604
47,25,0,1,4,5,0.3954956854457076,0.27049658372118174
47,26,0,1,23,24,2.8141395531170694,1.9247116043123498
47,27,0,2,10,12,0.39699987703291184,0.2715253653250629
47,28,0,0,1,1,0.11687393902428847,0.07993513556659926
47,29,0,1,6,7,0.7923679314406346,0.5419346566660185
47,30,0,3,8,11,0.7026981729179479,0.4806056352984269
47,31,0,0,3,3,0.40411115410143106,0.2763890749019738
47,32,0,1,3,4,0.5041134139708647,0.3447849402793548
47,33,0,2,4,6,0.5743770094732609,0.39284124845866164
47,34,0,1,34,35,1.6592015983146575,1.1347996465323016
47,35,0,1,32,33,0.5995191617526848,0.41003705248195366
47,36,0,2,11,13,0.4859936996262961,0.33239208491182803
47,37,0,0,4,4,1.0328043789201313,0.7063795293628392
47,38,0,1,9,10,0.74140016944177,0.5070756025525199
47,39,0,1,28,29,0.6482157125034453,0.44334272711211115
47,40,0,1,5,6,0.6817783467590206,0.4662976625030888
47,41,0,1,8,9,1.2529960419232793,0.8569781194311842
47,42,0,1,9,10,0.5680144755588932,0.3884896366687452
47,43,0,1,13,14,2.33644486833542,1.5979955741498888
47,44,0,2,23,25,0.7777227920376054,0.5319182131941373
47,45,0,1,31,32,2.0838329332932504,1.4252233595577168
47,46,0,1,11,12,1.8263753591415262,1.2491370030587803
47,48,0,1,33,34,1.6628277120615953,1.1372797023630643
47,49,0,2,3,5,0.6204474594502059,0.42435081932848595
47,50,0,3,9,12,0.598331995248548,0.4092250980270893
47,51,0,2,9,11,0.8656077977375967,0.5920265650093371
47,52,0,1,7,8,1.2055591155414525,0.8245339563196278
47,53,0,0,5,5,2.99897649207192,2.051129571366585
47,54,0,2,2,4,1.1116135085831031,0.7602804975007077
47,55,0,1,10,11,0.9856474250026128,0.6741268515137478
47,56,0,2,8,10,0.3191398594721178,0.2182735359531918
47,57,0,1,10,11,1.1792899779405426,0.8065673583519664
47,58,0,1,11,12,1.150581534912118,0.786932414030408
47,59,0,1,20,21,1.522426158944589,1.0412530151831565
47,60,0,1,19,20,1.1974870436570755,0.8190131176641692
47,61,0,1,18,19,1.203636337800363,0.8232188855632081
47,62,0,1,17,18,0.9004732371265955,0.6158725451090538
47,63,0,1,16,17,0.8621967819566055,0.5896936239691908
47,64,0,1,15,16,0.7603977376266682,0.5200688600825838
47,65,0,2,7,9,0.7322653425417285,0.5008278998334349
47,66,0,2,6,8,0.7641235016444045,0.522617071038193
47,67,0,2,5,7,0.8971042341581297,0.6135683384462439
47,68,0,1,14,15,2.3334215907729723,1.5959278240267458
47,69,0,1,12,13,2.1475024055010166,1.4687696619658523
47,70,0,0,7,7,0.08162329732975818,0.055825698970333654
47,71,0,0,8,8,1.0716610610855182,0.7329552928092392
47,72,0,0,6,6,1.675673723222254,1.1460656443120554
47,73,0,0,2,2,0.9118174136146212,0.6236313174498518
48,0,2,0,0,2,0.0005161839430268091,0.0003530404965180042
48,1,1,0,7,8,0.3633857145303162,0.248535187540054
48,2,1,1,6,8,3.8457506336158604,2.630274985337266
48,3,1,1,5,7,4.032328182245297,2.7578834305380244
48,4,1,1,6,8,4.176026188511768,2.8561647044255527
48,5,1,0,10,11,0.3965338114376901,0.27120660293159865
48,6,1,0,9,10,0.5568205482513797,0.3808336262328961
48,7,1,0,8,9,0.12694474333513148,0.08682299366886305
48,8,1,0,3,4,1.3374608977060085,0.9147472829758696
48,9,1,0,2,3,2.8467987489957824,1.9470486391710669
48,10,1,0,1,2,2.918264961515994,1.9959274690789668
48,11,1,0,1,2,0.051764369123146976,0.035403888137271834
48,12,1,0,0,1,0.0023252281335346724,0.0015903239646841891
48,13,0,0,11,11,0.05448461109161915,0.037264379127299886
48,14,1,1,1,3,0.2569893879065616,0.17576614370137109
48,15,1,2,6,9,9.240618365552049,6.3200580722799575
48,16,0,0,31,31,0.02954189829346001,0.020204980380542022
48,17,0,0,12,12,0.20134324513053292,0.13770734287977987
48,18,0,0,7,7,0.19025595076997567,0.1301242633226362
48,19,0,0,6,6,0.5301731442667996,0.3626083155452613
48,20,0,0,9,9,0.12851964516056022,0.08790013705917497
48,21,0,0,8,8,0.09399800040998427,0.06428929296376207
48,22,0,1,11,12,0.21269580666491641,0.14547185011599542
48,23,0,0,3,3,0.178222439235979,0.12189402496631317
48,24,0,0,4,4,0.07442633615790105,0.05090338633380658
48,25,0,0,29,29,0.6030668924066068,0.41246349872944504
48,26,0,0,10,10,0.8268829974086933,0.5655410012478806
48,27,0,1,39,40,1.2610727996586366,0.8625021629425457
48,28,1,0,3,4,1.479092212818308,1.0116150575070644
48,29,0,0,27,27,0.5857421596154919,0.4006143655875812
48,30,0,2,37,39,2.020757086190443,1.3820830630020136
48,31,1,0,5,6,0.6698906348083082,0.4581671427799587
48,32,0,0,30,30,1.0117630745232806,0.6919884723530227
48,33,0,1,33,34,1.3399644333422691,0.9164595591441155
48,34,0,0,1,1,0.47414663872185153,0.32428936819526616
48,35,0,0,1,1,0.5902794117624444,0.4037175883290609
48,36,0,1,40,41,1.9710159728136907,1.3480629668693935
48,37,1,0,6,7,1.6821494233650693,1.1504946553741109
48,38,1,1,7,9,1.8627015500267021,1.2739820542076188
48,39,0,0,5,5,0.06012539049991535,0.04112235183248726
48,40,0,0,28,28,0.7266646918200104,0.49699737287045914
48,41,0,0,25,25,0.47975447494284335,0.32812480963159096
48,42,0,0,24,24,0.10485969461883607,0.0717180748317804
48,43,0,0,20,20,0.8006598787416612,0.5476058776170033
48,44,0,1,12,13,0.19374606457303215,0.13251130291691396
48,45,0,0,2,2,0.6024635859941907,0.4120508714126344
48,46,0,0,22,22,0.33782272941671665,0.23105155776252168
48,47,1,0,2,3,1.7321122000641618,1.1846663566281919
48,49,0,1,32,33,1.5474128053876368,1.0583424620474793
48,50,0,2,38,40,1.7317712055189227,1.1844331357285738
48,51,0,1,38,39,2.4782702328655444,1.6949960674603937
48,52,0,0,26,26,0.634956202188958,0.43427397522966626
48,53,1,0,7,8,2.30293378107144,1.5750758939731673
48,54,0,1,31,32,2.6939385447217252,1.8425009422816385
48,55,1,1,8,10,0.22594371784797337,0.15453266885140102
48,56,0,1,37,38,0.9246132435427061,0.6323829382861792
48,57,0,0,23,23,0.20464687117164013,0.139966835437846
48,58,1,1,9,11,0.2571456128600135,0.17587299269557216
48,59,0,0,13,13,0.5470571853969087,0.37415604062336305
48,60,0,0,14,14,0.6173389104230071,0.4222247483670809
48,61,0,0,15,15,0.8929268945968577,0.6107112754694533
48,62,0,0,16,16,0.9759236191426002,0.6674763206414901
48,63,0,0,17,17,1.3759725949129693,0.9410870963066968
48,64,0,0,18,18,1.6213548819984174,1.1089146423581842
48,65,0,1,36,37,1.8370861175731807,1.2564625534287175
48,66,0,1,35,36,2.040194445468097,1.3953771126583112
48,67,0,1,34,35,2.2781609603167,1.558132691733824
48,68,0,0,19,19,0.8068491946066317,0.5518390181003415
48,69,0,0,21,21,0.3751660452964359,0.2565922646324369
48,70,1,0,5,6,0.20284754383708925,0.13873619774721313
48,71,1,0,6,7,2.4631258997507537,1.6846382038450933
48,72,1,0,4,5,0.3578621538812892,0.2447573858078941
48,73,1,0,4,5,7.272084845013815,4.973692961757607
49,0,3,0,0,3,0.000774765088589618,0.0005298953120405146
49,1,2,0,7,9,1.533837558331046,1.0490577641680559
49,2,2,1,6,9,0.6560386931998055,0.44869320154395587
49,3,2,1,5,8,0.5570242867368462,0.38097297178411016
49,4,2,1,6,9,0.3997813759486884,0.2734277525875024
49,5,2,0,10,12,0.4958583601210777,0.3391389523533795
49,6,2,0,9,11,1.0275614979057996,0.7027936965575201
49,7,2,0,8,10,0.569357732653087,0.38940834822088066
49,8,2,0,3,5,5.091040988551107,3.481982852570531
49,9,2,0,2,4,8.763825607272851,5.99395890861354
49,10,2,0,1,3,8.228013012904595,5.627493529533462
49,11,2,0,1,3,0.11256747662259961,0.07698975990145698
49,12,2,0,0,2,0.003877445647985072,0.0026519525748113543
49,13,1,0,20,21,0.22122546528582487,0.15130565210719413
49,14,2,1,1,4,0.4525420868672567,0.30951308191818805
49,15,2,2,6,10,1.5900078616157847,1.087475061004004
49,16,1,0,0,1,0.0027285534022948713,0.0018661755386529726
49,17,1,0,19,20,0.6055049466632568,0.41413098935354
49,18,1,0,24,25,1.0848785805505112,0.7419953253358129
49,19,1,0,25,26,1.8948876414061384,1.2959955124623246
49,20,1,0,22,23,1.0550031042933417,0.7215621965761391
49,21,1,0,23,24,0.872584018688308,0.5967979038731858
49,22,1,1,20,22,0.8211592227673038,0.5616262645175899
49,23,1,0,28,29,1.1186985944117784,0.7651262937572919
49,24,1,0,27,28,1.0005608236411994,0.6843267690649688
49,25,1,0,2,3,0.29206963249516443,0.19975903835615527
49,26,1,0,21,22,2.9542035328951677,2.0205074105034373
49,27,0,0,7,7,0.2725678413521705,0.18642092096385313
49,28,2,0,3,5,0.7442128077895398,0.5089992874176469
49,29,1,0,4,5,0.7514299293849761,0.5139353886387407
49,30,0,1,5,6,0.1709095358499474,0.1168924144410925
49,31,2,0,5,7,0.5470163411642922,0.37412810548830583
49,32,1,0,1,2,0.25895316804407714,0.1771092577679097
49,33,0,0,1,1,0.14517025061951347,0.09928820539792402
49,34,1,0,32,33,1.7894161773181887,1.2238590220636747
49,35,1,0,30,31,0.7014603923948703,0.4797590637296076
49,36,0,0,8,8,0.43084637954595745,0.29467445047973784
49,37,2,0,6,8,1.427136368453708,0.9760802111809016
49,38,2,1,7,10,0.16297348450882815,0.11146460611092211
49,39,1,0,26,27,0.7013445166987633,0.47967981133549376
49,40,1,0,3,4,0.5982905982905983,0.4091967848593004
49,41,1,0,6,7,1.2536244973604629,0.8574079472524095
49,42,1,0,7,8,0.5826670480547951,0.39851116395393354
49,43,1,0,11,12,2.425926632739507,1.6591960182188847
49,44,1,1,21,23,0.8435977600903631,0.5769729494826804
49,45,1,0,29,30,2.225566025228877,1.5221607436548947
49,46,1,0,9,10,1.886364587136185,1.2901662274720358
49,47,2,0,2,4,0.7678037310696298,0.5251341389190013
49,48,1,0,31,32,1.8383264128005126,1.2573108449124055
49,50,0,1,6,7,0.10621268858189357,0.07264344584914054
49,51,0,0,6,6,0.47286929684726464,0.32341573890919595
49,52,1,0,5,6,1.1826938711684474,0.8088954279703803
49,53,2,0,7,9,3.6040072141992168,2.464936218074644
49,54,0,0,1,1,0.4460851647843455,0.305096913982467
49,55,2,1,8,11,0.9895200021042937,0.6767754742794326
49,56,0,0,5,5,0.06408645880550673,0.04383149755512955
49,57,1,0,8,9,1.2153852915718124,0.8312545025735267
49,58,2,1,9,12,1.1645571306971574,0.7964909276993017
49,59,1,0,18,19,1.5569704452797075,1.0648793448362988
49,60,1,0,17,18,1.2062314046898943,0.8249937639094916
49,61,1,0,16,17,1.1778821374481352,0.805604475423948
49,62,1,0,15,16,0.8278531762019495,0.566204548433936
49,63,1,0,14,15,0.6790191779361626,0.46441054775580143
49,64,1,0,13,14,0.43057798497828387,0.294490883840918
49,65,0,0,4,4,0.21616088024422736,0.14784176361957727
49,66,0,0,3,3,0.060309178955831676,0.04124805269669955
49,67,0,0,2,2,0.3791952828029378,0.2593480342163244
49,68,1,0,12,13,2.4303034845534977,1.6621895362437507
49,69,1,0,10,11,2.230162067558439,1.525304175541853
49,70,2,0,5,7,0.018483925223960397,0.012641954920960645
49,71,2,0,6,8,0.4115020589441882,0.28144403399292084
49,72,2,0,4,6,1.7043359538529015,1.1656689819785115
49,73,2,0,4,6,3.965440865913075,2.7121363055301906
50,0,4,0,0,4,0.000739858673021249,0.0005060213065616561
50,1,3,0,7,10,1.5441988042322259,1.0561442678203166
50,2,3,1,6,10,0.7200906712669447,0.49250111623263254
50,3,3,1,5,9,0.6485131684555362,0.44354617008711456
50,4,3,1,6,10,0.5447183862758543,0.3725564348740807
50,5,3,0,10,13,0.5063006353946515,0.3462808754936906
50,6,3,0,9,12,1.043506695544635,0.7136993060162006
50,7,3,0,8,11,0.5740469004301654,0.3926154726241866
50,8,3,0,3,6,5.1218620710031,3.503062722254717
50,9,3,0,2,5,8.808589119941434,6.024574608601685
50,10,3,0,1,4,8.266676715040282,5.653937305601285
50,11,3,0,1,4,0.1109493589435795,0.0758830593220549
50,12,3,0,0,3,0.003868696965639293,0.002645968973033429
50,13,2,0,20,22,0.22094882104069793,0.15111644315759806
50,14,3,1,1,5,0.44443646837854006,0.3039692992908903
50,15,3,2,6,11,1.7579185924774157,1.202316463172557
50,16,2,0,0,2,0.001583597415528095,0.0010830906800090641
50,17,2,0,19,21,0.6056074664170696,0.4142011070417748
50,18,2,0,24,26,1.0859055662845958,0.7426977252426217
50,19,2,0,25,27,1.8958329927647803,1.2966420790933628
50,20,2,0,22,24,1.0556277500399815,0.7219894187854323
50,21,2,0,23,25,0.8732452511714861,0.5972501493320549
50,22,2,1,20,23,0.8212020698379742,0.56165556948011
50,23,2,0,28,30,1.1177393984499349,0.764470258204071
50,24,2,0,27,29,0.999116906079508,0.6833392114708262
50,25,2,0,2,4,0.29990171323867565,0.2051157367033464
50,26,2,0,21,23,2.959426841415068,2.0240798568343306
50,27,1,0,2,3,0.23173551552555471,0.15849392947457186
50,28,3,0,3,6,0.6507011732372746,0.4450426410737926
50,29,2,0,4,6,0.7597878328983744,0.5196517198925132
50,30,0,0,1,1,0.11668526637450372,0.07980609419121515
50,31,3,0,5,8,0.5225158879743234,0.357371187192121
50,32,2,0,1,3,0.2741600508887606,0.18750990184547905
50,33,1,0,4,5,0.17593218350997913,0.12032762014186435
50,34,2,0,32,34,1.7856195594225004,1.22126235108022
50,35,2,0,30,32,0.6858636530807591,0.46909177997175205
50,36,1,0,3,4,0.32633735242257317,0.22319621229607378
50,37,3,0,6,9,1.3622291837991511,0.9316873837642603
50,38,3,1,7,11,0.18748571047515356,0.12822957631741222
50,39,2,0,26,28,0.6996756066545384,0.47853837166342234
50,40,2,0,3,5,0.607821587647268,0.41571544019572126
50,41,2,0,6,8,1.263285312808827,0.8640153962611093
50,42,2,0,7,9,0.5858152913295757,0.40066438352595396
50,43,2,0,11,13,2.4336137726666967,1.6644535852807052
50,44,2,1,21,24,0.8406318447363693,0.5749444318518057
50,45,2,0,29,31,2.223925589022754,1.5210387784707013
50,46,2,0,9,11,1.8949107357631811,1.2960113076907258
50,47,3,0,2,5,0.6581651947734027,0.4501476078297982
50,48,2,0,31,33,1.8287503930279825,1.250761391329374
50,49,1,0,5,6,0.09441127873946095,0.0645719518659027
50,51,1,0,1,2,0.42060193976673144,0.28766783558002
50,52,2,0,5,7,1.1935059115675741,0.8162902494530045
50,53,3,0,7,10,3.5329228692401426,2.4163185638875486
50,54,1,0,6,7,0.4604321766686199,0.3149094551658933
50,55,3,1,8,12,0.9981473537570742,0.6826760927552282
50,56,1,0,0,1,0.028448270840288056,0.019457001323290538
50,57,2,0,8,10,1.2212680813382975,0.8352779966169342
50,58,3,1,9,13,1.1733439866940603,0.8025006380862396
50,59,2,0,18,20,1.5638403052482304,1.069577938829895
50,60,2,0,17,19,1.2122614360387123,0.8291179628315323
50,61,2,0,16,18,1.1848053644351833,0.8103395694268379
50,62,2,0,15,17,0.8339569301690305,0.5703791694392433
50,63,2,0,14,16,0.6860962303559709,0.46925084961703795
50,64,2,0,13,15,0.4378472109832566,0.2994626215184765
50,65,1,0,1,2,0.22384954247399372,0.15310037184988978
50,66,1,0,2,3,0.06534500521564485,0.04469227181114517
50,67,1,0,3,4,0.3736666109128713,0.2555667366856245
50,68,2,0,12,14,2.436827551197121,1.6666516272450231
50,69,2,0,10,12,2.2384787311153107,1.5309923010078923
50,70,3,0,5,8,0.021544745342001615,0.014735382019620795
50,71,3,0,6,9,0.44623321618525985,0.30519817273101024
50,72,3,0,4,7,1.7159462611575447,1.1736097726809935
50,73,3,0,4,7,3.507900129963695,2.399204431575342
51,0,3,0,0,3,0.0008497992224712447,0.0005812143974929499
51,1,2,0,7,9,1.812667999994831,1.2397619480140156
51,2,2,1,6,9,0.5069444444444444,0.3467212043138179
51,3,2,1,5,8,0.5812265181330628,0.3975259233130968
51,4,2,1,6,9,0.7323498588962939,0.5008857042192216
51,5,2,0,10,12,0.6778950147580614,0.46364168399720235
51,6,2,0,9,11,1.3433841266074449,0.9187984350905419
51,7,2,0,8,10,0.6855298300162123,0.4688634639575697
51,8,2,0,3,5,5.955782314289754,4.073416799950318
51,9,2,0,2,4,10.081020644639823,6.894845494268016
51,10,2,0,1,3,9.396971788771294,6.426994932504503
51,11,2,0,1,3,0.12196261127665534,0.08341549833816979
51,12,2,0,0,2,0.005083159962262709,0.0034765926782508645
51,13,1,0,20,21,0.27446302062064504,0.1877171159326651
51,14,2,1,1,4,0.47902622397029887,0.3276267273328097
51,15,2,2,6,10,1.275,0.8720275768769447
51,16,1,0,0,1,0.004109170649062416,0.0028104393130005973
51,17,1,0,19,20,0.685716610859153,0.46899121144453176
51,18,1,0,24,25,1.2681149389619728,0.8673185862152657
51,19,1,0,25,26,2.1683533379841737,1.4830305154002932
51,20,1,0,22,23,1.278427102864618,0.8743715205685062
51,21,1,0,23,24,1.0366371965006185,0.7090009588744655
51,22,1,1,20,22,1.021729953933735,0.6988052517266096
51,23,1,0,28,29,1.3041733226667211,0.8919804724647957
51,24,1,0,27,28,1.1854239894325669,0.810762673785633
51,25,1,0,2,3,0.47872438114117943,0.327420283983104
51,26,1,0,21,22,3.3923225649003164,2.320155942160788
51,27,0,0,1,1,0.06461965629663921,0.044196174352140634
51,28,2,0,3,5,0.818781207554619,0.5599998371892024
51,29,1,0,4,5,1.0224869641402452,0.6993230037078285
51,30,0,1,1,2,0.2727496308175524,0.1865452546320874
51,31,2,0,5,7,0.49826125037238567,0.3407823927952221
51,32,1,0,1,2,0.5289005101937014,0.3617379061279947
51,33,0,0,5,5,0.4689334101812144,0.32072381599762106
51,34,1,0,32,33,2.0402688396799196,1.3954279940734242
51,35,1,0,30,31,0.9253805106582766,0.6329077054105778
51,36,0,0,2,2,0.6726695365120604,0.4600677536969016
51,37,2,0,6,8,1.316582340895036,0.9004675360703324
51,38,2,1,7,10,0.252755730960957,0.1728705628326622
51,39,1,0,26,27,0.8456024437567284,0.5783440392395316
51,40,1,0,3,4,0.8704741126547669,0.5953548479940746
51,41,1,0,6,7,1.5954633110333818,1.0912062785227505
51,42,1,0,7,8,0.707688883306468,0.4840189977196001
51,43,1,0,11,12,2.770764603559854,1.8950456026185942
51,44,1,1,21,23,1.0416764060903345,0.7124474919943833
51,45,1,0,29,30,2.5430176514350435,1.7392796239499604
51,46,1,0,9,10,2.2406551746754375,1.5324808647756933
51,47,2,0,2,4,0.793473814592797,0.5426910179252257
51,48,1,0,31,32,2.180877804921679,1.4915965393651465
51,49,0,0,6,6,0.35027355322019604,0.23956721400681186
51,50,0,1,2,3,0.35050161647227623,0.23972319631668332
51,52,1,0,5,6,1.5466178025675685,1.0577987252766603
51,53,2,0,7,9,3.7568204641691354,2.569451800887161
51,54,0,0,7,7,0.2451102938112898,0.16764151810184708
51,55,2,1,8,11,1.1999221690415858,0.8206786051060877
51,56,0,0,1,1,0.1536590742882148,0.10509407860133833
51,57,1,0,8,9,1.455433154536521,0.9954336055347845
51,58,2,1,9,12,1.3921467459855932,0.9521492969089729
51,59,1,0,18,19,1.9708494232131468,1.3479490564030467
51,60,1,0,17,18,1.5688153621841547,1.072980595178647
51,61,1,0,16,17,1.5929494788259408,1.089486960084688
51,62,1,0,15,16,1.1919184349879242,0.8152045056450821
51,63,1,0,14,15,1.0966615765679075,0.7500542253086763
51,64,1,0,13,14,0.8501505156351398,0.581454662062742
51,65,0,0,2,2,0.6366891602145381,0.4354592200829024
51,66,0,0,3,3,0.44103889411530245,0.30164555148537614
51,67,0,0,4,4,0.15013015186830392,0.10268049611755668
51,68,1,0,12,13,2.7708499324155262,1.8951039627089865
51,69,1,0,10,11,2.6450469029154187,1.8090618364511375
51,70,2,0,5,7,0.02758749425697097,0.018868279034520017
51,71,2,0,6,8,0.29914045656698135,0.20459508038115112
51,72,2,0,4,6,2.0345800101989684,1.3915371578479028
51,73,2,0,4,6,4.457001196921304,3.0483356501089625
52,0,2,0,0,2,0.0005573150184152569,0.0003811718157378717
52,1,1,0,7,8,0.6369186905872231,0.4356162058199315
52,2,1,1,6,8,2.7754330381730914,1.8982385467155278
52,3,1,1,5,7,2.86160391638821,1.9571745326977141
52,4,1,1,6,8,2.8949517872830386,1.9799825821490262
52,5,1,0,10,11,0.09036793230395217,0.06180653257599623
52,6,1,0,9,10,0.08367872707051865,0.057231496159569864
52,7,1,0,8,9,0.19818274487782597,0.13554574023108418
52,8,1,0,3,4,2.300848747457704,1.5736498494163882
52,9,1,0,2,3,4.498997873669641,3.077058991490717
52,10,1,0,1,2,4.436249303172259,3.0341425335430117
52,11,1,0,1,2,0.07499084505823048,0.05128947835614363
52,12,1,0,0,1,0.0005742512824361989,0.0003927552583069149
52,13,0,0,15,15,0.044080787061733136,0.03014875445354645
52,14,1,1,1,3,0.33441551699105343,0.22872121800137965
52,15,1,2,6,9,6.664650736868695,4.55824253553157
52,16,0,0,5,5,0.020613912785929726,0.014098745424836837
52,17,0,0,14,14,0.33224004914384125,0.227233321565789
52,18,0,0,19,19,0.46655077488780733,0.3190942287964514
52,19,0,0,20,20,0.9671047264295946,0.6614446989605018
52,20,0,0,17,17,0.3040598133024796,0.20795964095671965
52,21,0,0,18,18,0.31940106369187726,0.21845218480246775
52,22,0,1,15,16,0.15422046108504525,0.10547803528222523
52,23,0,0,23,23,0.485166244417542,0.3318261525505229
52,24,0,0,22,22,0.3703648726443814,0.25330853525679853
52,25,0,0,3,3,0.30270947528047687,0.20703608645217697
52,26,0,0,16,16,1.4851238401820848,1.0157403480126794
52,27,0,1,13,14,0.9394445491234378,0.642526708848914
52,28,1,0,3,4,1.1055648336419575,0.7561435474205166
52,29,0,0,1,1,0.12717495581974897,0.0869804459317084
52,30,0,2,11,13,1.4093561374692423,0.9639195431481988
52,31,1,0,5,6,0.643141151044003,0.43987201532137343
52,32,0,0,4,4,0.5881558828630604,0.40226521518352526
52,33,0,1,7,8,0.8467741935483871,0.5791454495387678
52,34,0,0,27,27,0.9192674254093208,0.6287267023385079
52,35,0,0,25,25,0.28457313169719767,0.1946318576299537
52,36,0,1,14,15,1.3222293706199217,0.9043297836370339
52,37,1,0,6,7,1.6320757761707136,1.1162471249989854
52,38,1,1,7,9,1.3018571202675129,0.8903963215897068
52,39,0,0,21,21,0.2121117068435914,0.14507235901650972
52,40,0,0,2,2,0.27778143032151903,0.18998671967426362
52,41,0,0,1,1,0.13949275362318841,0.09540511994817383
52,42,0,0,2,2,0.17267181459507383,0.11809771300100963
52,43,0,0,6,6,1.2870423660960817,0.880263871250773
52,44,0,1,16,17,0.18485284038831173,0.12642884273148244
52,45,0,0,24,24,1.136887309763831,0.7775663418945113
52,46,0,0,4,4,0.7216008509614968,0.4935339933618003
52,47,1,0,2,3,1.3060223751699067,0.8932451193462634
52,48,0,0,26,26,0.6603544502765163,0.4516449342388529
52,49,0,1,6,7,1.0353549040531864,0.708123943677774
52,50,0,2,12,14,1.175422488665035,0.8039222153703831
52,51,0,1,12,13,1.8278210393980354,1.2501257662360528
52,53,1,0,7,8,2.83494268019655,1.9389397615661403
52,54,0,1,5,6,1.9534313725490196,1.3360360991367264
52,55,1,1,8,10,0.31835277891616437,0.21773521756102315
52,56,0,1,11,12,0.6368573420518416,0.4355742469064776
52,57,0,0,3,3,0.4269307768613393,0.2919964006592826
52,58,1,1,9,11,0.43472435033130474,0.2973267622186759
52,59,0,0,13,13,0.19341231270030776,0.13228303559389434
52,60,0,0,12,12,0.0548268314360086,0.03749843840390845
52,61,0,0,11,11,0.20613207822527135,0.14098263269913114
52,62,0,0,10,10,0.37896665111359074,0.259191663127651
52,63,0,0,9,9,0.6992274344603769,0.4782318473398943
52,64,0,0,8,8,0.948490005649151,0.6487132873084147
52,65,0,1,10,11,1.1668536126337041,0.7980615908981006
52,66,0,1,9,10,1.371960055589321,0.9383427473313836
52,67,0,1,8,9,1.6572769353001258,1.1334832863559356
52,68,0,0,7,7,1.299965116729881,0.8891022986404021
52,69,0,0,5,5,0.8578865821045938,0.586745692100324
52,70,1,0,5,6,0.14191215674298596,0.09705985425409193
52,71,1,0,6,7,1.7784058030312155,1.216328551467614
52,72,1,0,4,5,0.6384830383634148,0.43668613084006114
52,73,1,0,4,5,5.426610073131581,3.71149304527761
53,0,1,0,0,1,0.0009301734135642689,0.0006361857787496515
53,1,0,0,14,14,1.9119229953189567,1.3076467268888627
53,2,0,1,13,14,6.839735772378695,4.677990754561531
53,3,0,1,12,13,7.337998218889291,5.018773965447345
53,4,0,1,13,14,7.835827630750614,5.359261005230485
53,5,0,0,17,17,1.3947842307371625,0.953953186663452
53,6,0,0,16,16,2.358194686790344,1.6128712145300934
53,7,0,0,15,15,0.8106211836595515,0.5544188443543212
53,8,0,0,10,10,5.882194030425233,4.023086593781761
53,9,0,0,9,9,8.904028989905997,6.0898500584390565
53,10,0,0,8,8,7.908024185427051,5.408639347688021
53,11,0,0,6,6,0.04005025553455883,0.027392099833022574
53,12,0,0,7,7,0.009282549517611842,0.00634873659849671
53,13,0,1,27,28,0.38319304775540036,0.2620822783609672
53,14,0,1,6,7,0.0632406399467287,0.04325300550030835
53,15,0,2,13,15,16.453271373465185,11.253103033334623
53,16,0,1,7,8,0.055083251716972786,0.03767381531078791
53,17,0,1,26,27,0.5074117826338015,0.3470408370893842
53,18,0,1,31,32,1.202300705748,0.8223053891065637
53,19,0,1,32,33,1.7454676977618953,1.1938007584284587
53,20,0,1,29,30,1.5481506094059627,1.058847078086939
53,21,0,1,30,31,1.1022925505950083,0.7539054916900957
53,22,0,2,27,29,1.4449981844578281,0.9882966787328191
53,23,0,1,35,36,1.2028399734528743,0.8226742175849713
53,24,0,1,34,35,1.2337067459771163,0.8437853366832667
53,25,0,1,9,10,1.5424113005689466,1.0549217168492198
53,26,0,1,28,29,2.8417075181222797,1.943566526447975
53,27,0,2,15,17,2.14464660883368,1.46681645926164
53,28,0,0,4,4,2.779735734843746,1.9011813468345449
53,29,0,1,11,12,2.0883544933262455,1.4283158497846002
53,30,0,3,13,16,3.766687983899855,2.5762006238836817
53,31,0,0,2,2,0.6535111268060716,0.4469644897026042
53,32,0,1,8,9,2.299799112680339,1.572931958850497
53,33,0,2,9,11,2.8033445908238153,1.917328463284064
53,34,0,1,39,40,1.5531097474743465,1.0622388468345239
53,35,0,1,37,38,1.8927421889489229,1.294528144848544
53,36,0,2,16,18,3.941718900610837,2.6959118287291943
53,37,0,0,1,1,1.6053240740740742,1.09795048032709
53,38,0,1,14,15,3.456627200746165,2.3641366604185214
53,39,0,1,33,34,0.9949799773272607,0.6805097871919754
53,40,0,1,10,11,2.1688832970100207,1.4833929772710015
53,41,0,1,13,14,2.501837174149575,1.7111145166386796
53,42,0,1,14,15,0.8713371588796408,0.5959451225887487
53,43,0,1,18,19,2.2778048778875672,1.557889151578651
53,44,0,2,28,30,1.4252771171974776,0.9748085889316656
53,45,0,1,36,37,1.9973523610223691,1.3660755604327695
53,46,0,1,16,17,2.4070919141179337,1.646314140539881
53,47,0,0,5,5,3.1239338459082497,2.1365933035068596
53,48,0,1,38,39,2.30293378107144,1.5750758939731673
53,49,0,2,8,10,3.033676106228297,2.0748621364264683
53,50,0,3,14,17,3.34557089890165,2.288180458226845
53,51,0,2,14,16,4.269114163828563,2.919831591917228
53,52,0,1,12,13,2.7259064232659136,1.8643651553520582
53,54,0,2,7,9,4.7537824637248915,3.2513171786997095
53,55,0,1,15,16,1.477518980077126,1.0105390556755693
53,56,0,2,13,15,1.7525123395263824,1.1986188932424602
53,57,0,1,15,16,1.645988089745635,1.125762357230743
53,58,0,1,16,17,1.5763455721420325,1.078130831055465
53,59,0,1,25,26,3.021877110460821,2.066792293533375
53,60,0,1,24,25,2.7191379314201574,1.8597358913964768
53,61,0,1,23,24,3.2131516166442204,2.1976131909023504
53,62,0,1,22,23,2.92777606916609,2.002432526457421
53,63,0,1,21,22,3.5121936202079014,2.402140935021616
53,64,0,1,20,21,3.678122399128656,2.5156267946423343
53,65,0,2,12,14,3.830805236235842,2.6200531824645124
53,66,0,2,11,13,3.979755475299459,2.7219266852456006
53,67,0,2,10,12,4.000668346941824,2.7362299015466434
53,68,0,1,19,20,2.2353213282012545,1.5288328167628968
53,69,0,1,17,18,2.805000808561945,1.9184612221397206
53,70,0,0,12,12,0.37592985501690795,0.2571146670949768
53,71,0,0,13,13,4.376232629746231,2.993094538013667
53,72,0,0,11,11,2.2769208086844084,1.557284498460987
53,73,0,0,3,3,13.9650006025802,9.551267165923989
54,0,3,0,0,3,0.0009038577688227299,0.0006181873725395192
54,1,2,0,7,9,1.7996143699633649,1.2308340065506531
54,2,2,1,6,9,0.15975995931010198,0.10926673741109612
54,3,2,1,5,8,0.24129709558534826,0.16503350711430254
54,4,2,1,6,9,0.4491224206223616,0.3071742244520988
54,5,2,0,10,12,0.6640251495626421,0.45415548404585226
54,6,2,0,9,11,1.3222001480765389,0.9043097970772718
54,7,2,0,8,10,0.6794912481336124,0.46473341695611353
54,8,2,0,3,5,5.917494025108102,4.04722978501868
54,9,2,0,2,4,10.026609080865464,6.857631075356457
54,10,2,0,1,3,9.350572377128131,6.3952603705408135
54,11,2,0,1,3,0.12474168891540637,0.0853162295846584
54,12,2,0,0,2,0.005096950961635124,0.0034860249384590512
54,13,1,0,20,21,0.2751651869369394,0.1881973578082438
54,14,2,1,1,4,0.49292375318493764,0.33713184790192186
54,15,2,2,6,10,0.4417452760232857,0.30212867658621406
54,16,1,0,0,1,0.004580458682783503,0.003132773557751106
54,17,1,0,19,20,0.6866067074585283,0.4695999869588373
54,18,1,0,24,25,1.2684733301601654,0.8675637054373315
54,19,1,0,25,26,2.170225938566323,1.4843112678301835
54,20,1,0,22,23,1.2792202748187633,0.8749140051310317
54,21,1,0,23,24,1.0371566671257582,0.7093562472748571
54,22,1,1,20,22,1.022794525784778,0.6995333584024341
54,23,1,0,28,29,1.3076203106162396,0.8943380164249076
54,24,1,0,27,28,1.189319238781628,0.8134268030806867
54,25,1,0,2,3,0.4680861054707435,0.3201443077046419
54,26,1,0,21,22,3.38942535742648,2.318174416817165
54,27,0,0,8,8,0.1807879785101976,0.12364870810096375
54,28,2,0,3,5,0.9443278626762917,0.6458666179348946
54,29,1,0,4,5,1.0114326069330308,0.6917624512926606
54,30,0,1,6,7,0.28331035446034164,0.19376818972878435
54,31,2,0,5,7,0.5421166182879342,0.370776973357138
54,32,1,0,1,2,0.5096437346403355,0.3485673654815125
54,33,0,0,2,2,0.43870967741935485,0.3000524995705616
54,34,1,0,32,33,2.049336161444169,1.4016295271140846
54,35,1,0,30,31,0.945663021050689,0.6467797904227165
54,36,0,0,9,9,0.7561929740161021,0.517193040613829
54,37,2,0,6,8,1.4317017350378622,0.9792026626004585
54,38,2,1,7,10,0.17411347071915792,0.11908372390028403
54,39,1,0,26,27,0.849198585390984,0.580803595847709
54,40,1,0,3,4,0.8575510406897594,0.5865162008321515
54,41,1,0,6,7,1.5833333333333333,1.0829100627883625
54,42,1,0,7,8,0.7040012626251303,0.4814968746394525
54,43,1,0,11,12,2.762965445336984,1.889711421405442
54,44,1,1,21,23,1.0471108038933723,0.7161643114045547
54,45,1,0,29,30,2.5495003762242017,1.7437134394710978
54,46,1,0,9,10,2.2310638215750864,1.525920924067403
54,47,2,0,2,4,0.9448714822956377,0.6462384228756015
54,48,1,0,31,32,2.1982538524929276,1.503480768901817
54,49,0,0,1,1,0.3064019313670252,0.20956151667482584
54,50,0,1,7,8,0.35578850015302443,0.24333912444637207
54,51,0,0,7,7,0.22728409062501417,0.15544940769444002
54,52,1,0,5,6,1.5326923076923078,1.0482744777842006
54,53,2,0,7,9,3.8790864903995113,2.653074817818963
54,55,2,1,8,11,1.1887648979226664,0.8130476654210755
54,56,0,0,6,6,0.1576694940625461,0.10783697792531442
54,57,1,0,8,9,1.448720217833485,0.9908423381411559
54,58,2,1,9,12,1.3809446838865955,0.9444877227378246
54,59,1,0,18,19,1.9630487684098967,1.3426138516139239
54,60,1,0,17,18,1.5615048100241369,1.0679805927584642
54,61,1,0,16,17,1.5838229374704904,1.083244924207464
54,62,1,0,15,16,1.182905443941586,0.8090401317293552
54,63,1,0,14,15,1.0843919086489753,0.7416624693993186
54,64,1,0,13,14,0.8349318347543255,0.5710459487986167
54,65,0,0,5,5,0.6170128999350213,0.4220017757114929
54,66,0,0,4,4,0.41323590240099334,0.28262988443082027
54,67,0,0,3,3,0.0584819535317425,0.039998334297502346
54,68,1,0,12,13,2.76486232348377,1.891008778310519
54,69,1,0,10,11,2.636402628914531,1.803149644050467
54,70,2,0,5,7,0.01807506746664428,0.012362319439078517
54,71,2,0,6,8,0.0759256756772096,0.05192884939885637
54,72,2,0,4,6,2.020064316497248,1.3816092478828839
54,73,2,0,4,6,5.068968775248516,3.46688671242734
55,0,2,0,0,2,0.0006785611415375016,0.00046409727687670674
55,1,1,0,1,2,0.21493217077867824,0.147001396138849
55,2,1,1,2,4,3.763914514057911,2.5743037280516736
55,3,1,1,3,5,3.9394103292199842,2.694332897030361
55,4,1,1,4,6,4.070266812055059,2.7838312983207993
55,5,1,0,2,3,0.3423018135538611,0.2341149968893782
55,6,1,0,1,2,0.4383146945543851,0.29978235372691653
55,7,1,0,0,1,0.022432430937359697,0.015342508544129559
55,8,1,0,5,6,0.9910029146574212,0.6777897022327064
55,9,1,0,6,7,2.5000096450431233,1.7098645905379966
55,10,1,0,7,8,2.660500988217569,1.8196315529679088
55,11,1,0,9,10,0.06437839400434994,0.04403116464850393
55,12,1,0,8,9,0.0023727161455985714,0.001622803067500491
55,13,1,1,28,30,0.062005555535238614,0.04240827791866899
55,14,1,1,9,11,0.30751278259280873,0.2103212758141911
55,15,1,2,2,5,9.033367927363035,6.178310544891212
55,16,1,1,8,10,0.029520884238504845,0.020190607960602486
55,17,1,1,27,29,0.21205122179149383,0.14503099067657407
55,18,1,1,32,34,0.20928844424038798,0.14314140776414985
55,19,1,1,33,35,0.5625131362612636,0.38472703307871403
55,20,1,1,30,32,0.15660044909063287,0.10710581188889877
55,21,1,1,31,33,0.11990783147371675,0.0820101456694857
55,22,1,2,28,31,0.22539129212971218,0.15415484103924432
55,23,1,1,36,38,0.23739946702645404,0.16236775057486813
55,24,1,1,35,37,0.1699928511568779,0.11626545418096891
55,25,1,1,10,12,0.5813996112578449,0.39764430917833427
55,26,1,1,29,31,0.8297608152125615,0.5675092651586261
55,27,1,2,16,19,1.277781616708656,0.8739300447030229
55,28,1,0,11,12,1.617731873433164,1.1064367102953114
55,29,1,1,12,14,0.5408402382083882,0.36990400188424344
55,30,1,3,14,18,2.012616456257873,1.376515334535856
55,31,1,0,13,14,0.7351459435551819,0.5027980673014436
55,32,1,1,9,11,0.9846028320651968,0.6734124092799929
55,33,1,2,10,13,1.310548137381997,0.8963404836249537
55,34,1,1,40,42,0.5635426728891051,0.38543117765195534
55,35,1,1,38,40,0.6491105619268094,0.443954753288053
55,36,1,2,17,20,2.0205512529669174,1.3819422847689535
55,37,1,0,14,15,1.8620624181005876,1.2735449242744155
55,38,1,1,5,7,1.8340112850497912,1.254359542640738
55,39,1,1,34,36,0.13359029848747336,0.09136817590925427
55,40,1,1,11,13,0.6890259054661313,0.47125458097966527
55,41,1,1,14,16,0.3893073370596948,0.26626410493849534
55,42,1,1,15,17,0.039061205534107336,0.02671564581317641
55,43,1,1,19,21,0.7635043925715126,0.5221936355992468
55,44,1,2,29,32,0.24927101328692855,0.1704872138841263
55,45,1,1,37,39,0.6756421737419709,0.4621008687090844
55,46,1,1,17,19,0.20511459819579184,0.14028673415432508
55,47,1,0,10,11,1.8727301075049643,1.280841017876121
55,48,1,1,39,41,0.4121213413547034,0.2818675879849555
55,49,1,2,9,12,1.519263033533865,1.0390896170754926
55,50,1,3,15,19,1.7240727019440372,1.1791677965772123
55,51,1,2,15,18,2.4871114049225596,1.7010429269471636
55,52,1,1,13,15,0.5583417968683498,0.38187407387625605
55,53,1,0,15,16,2.6949946196606778,1.8432232375522388
55,54,1,2,8,11,2.6572391835918423,1.8174006638824043
55,56,1,2,14,17,0.9208137291957763,0.6297842862946008
55,57,1,1,16,18,0.08986255850705156,0.061460885605385776
55,58,0,0,1,1,0.09050751337499148,0.061901998100040385
55,59,1,1,26,28,0.4875073586571776,0.33342734170941035
55,60,1,1,25,27,0.5752276426079613,0.39342303320475114
55,61,1,1,24,26,0.852783744448684,0.5832556409973597
55,62,1,1,23,25,0.9459418101570123,0.6469704663355375
55,63,1,1,22,24,1.3461283532291215,0.9206753302209748
55,64,1,1,21,23,1.5943563772422595,1.0904491986861737
55,65,1,2,13,16,1.8119556272583117,1.239274725526753
55,66,1,2,12,15,2.0164591000801173,1.3791434846386899
55,67,1,2,11,14,2.2579383495298933,1.544301574649475
55,68,1,1,20,22,0.7833492557248246,0.535766394759276
55,69,1,1,18,20,0.26373313370967727,0.18037848276942212
55,70,1,0,3,4,0.1995406791947194,0.13647449016984387
55,71,1,0,2,3,2.415442618256918,1.652025547830497
55,72,1,0,4,5,0.1409995868350483,0.09643570827326864
55,73,1,0,12,13,8.014848292792463,5.481700969255003
56,0,3,0,0,3,0.000759601842466218,0.0005195245130016305
56,1,2,0,7,9,1.5865341877095636,1.0850992653653353
56,2,2,1,6,9,0.6366298376249113,0.43541864680126613
56,3,2,1,5,8,0.5678534404614394,0.3883794978092748
56,4,2,1,6,9,0.48417692346669766,0.33114951321599867
56,5,2,0,10,12,0.5328722127778673,0.364454325093129
56,6,2,0,9,11,1.090225222414061,0.7456521246681269
56,7,2,0,8,10,0.5915787968740323,0.40460629393712993
56,8,2,0,3,5,5.2535426850651605,3.5931247824917407
56,9,2,0,2,4,9.009859354419454,6.16223201634233
56,10,2,0,1,3,8.445619819290476,5.776324224501783
56,11,2,0,1,3,0.1128655570863024,0.07719363000692923
56,12,2,0,0,2,0.004063832553907116,0.0027794306312292297
56,13,1,0,20,21,0.22956636448519158,0.1570103533760558
56,14,2,1,1,4,0.45071058412176235,0.308260438074112
56,15,2,2,6,10,1.561738703425697,1.0681405625594134
56,16,1,0,0,1,0.0007680491551459293,0.0005253019950465014
56,17,1,0,19,20,0.6185362507008966,0.4230436611052967
56,18,1,0,24,25,1.1151885698718484,0.7627256363499713
56,19,1,0,25,26,1.939734818527401,1.3266684341837567
56,20,1,0,22,23,1.09141458431173,0.7464655806474634
56,21,1,0,23,24,0.8995021297017336,0.6152083627917285
56,22,1,1,20,22,0.8534056682304736,0.5836810015373096
56,23,1,0,28,29,1.147875547509156,0.7850816723534946
56,24,1,0,27,28,1.0292409934361557,0.7039423761008237
56,25,1,0,2,3,0.32768749067534847,0.2241196301698122
56,26,1,0,21,22,3.028822457913221,2.071542516678069
56,27,0,0,2,2,0.20235798967108024,0.13840137050553877
56,28,2,0,3,5,0.6775030902586945,0.4633736299019069
56,29,1,0,4,5,0.8011471367319973,0.5479391344049458
56,30,0,1,0,1,0.05625,0.03847180486221815
56,31,2,0,5,7,0.5204068891314403,0.35592875177988925
56,32,1,0,1,2,0.3130360378443783,0.21409886867183744
56,33,0,0,4,4,0.21787928762281655,0.149017056656784
56,34,1,0,32,33,1.8270529837319947,1.249600459787924
56,35,1,0,30,31,0.7251250424309548,0.49594434014420175
56,36,0,0,3,3,0.37647854723079033,0.25748994140221054
56,37,2,0,6,8,1.3595458411244012,0.9298521297951682
56,38,2,1,7,10,0.14665918424609875,0.10030655142343127
56,39,1,0,26,27,0.7232861178825332,0.4946866202085001
56,40,1,0,3,4,0.6489741457274801,0.44386145235648605
56,41,1,0,6,7,1.3157961755984042,0.8999298436635508
56,42,1,0,7,8,0.6051526896393816,0.4138900655582712
56,43,1,0,11,12,2.487347957730439,1.701204715630974
56,44,1,1,21,23,0.8731595947753299,0.5971915652225772
56,45,1,0,29,30,2.2755725058964473,1.5563623359409224
56,46,1,0,9,10,1.9498563672938112,1.3335909986112189
56,47,2,0,2,4,0.6781722013782504,0.4638312639005326
56,48,1,0,31,32,1.8862110168271207,1.2900611941038056
56,49,0,0,5,5,0.11004745451450651,0.07526620792294975
56,50,0,1,1,2,0.05495688685055647,0.03758738891999309
56,51,0,0,1,1,0.35620967221358885,0.24362718221219343
56,52,1,0,5,6,1.2492201709478432,0.8543956381627063
56,53,2,0,7,9,3.57512517263382,2.445182542214619
56,54,0,0,6,6,0.3941737351563653,0.2695924448132861
56,55,2,1,8,11,1.02985746028475,0.7043640044084352
56,57,1,0,8,9,1.2584598666739153,0.8607150652019901
56,58,2,1,9,12,1.207800727095278,0.8260670912934175
56,59,1,0,18,19,1.6286094259547537,1.1138763383484516
56,60,1,0,17,18,1.2689316492694074,0.867877169674405
56,61,1,0,16,17,1.249563460125216,0.854630428460363
56,62,1,0,15,16,0.8906014422597114,0.6091207981622341
56,63,1,0,14,15,0.750760270484024,0.5134773799887554
56,64,1,0,13,14,0.5022519837350733,0.3435118277318703
56,65,0,0,1,1,0.28694107437907235,0.1962513959194115
56,66,0,0,2,2,0.09954956750436497,0.0680862495137092
56,67,0,0,3,3,0.3146040280168778,0.21517128488414464
56,68,1,0,12,13,2.4901677327783047,1.7031332815935847
56,69,1,0,10,11,2.303248047968768,1.57529083467981
56,70,2,0,5,7,0.017174396307211744,0.011746311526354672
56,71,2,0,6,8,0.39088001879654544,0.2673397299143264
56,72,2,0,4,6,1.7662360326940252,1.2080051198297403
56,73,2,0,4,6,3.6627456228743798,2.5051099531229655
57,0,2,0,0,2,0.0006581638114071969,0.0004501466616858921
57,1,1,0,7,8,0.16345526151314252,0.11179411421575922
57,2,1,1,6,8,3.9306184354020197,2.6883197410599777
57,3,1,1,5,7,4.1216055126414695,2.818944053357959
57,4,1,1,6,8,4.269267026062732,2.91993614100245
57,5,1,0,10,11,0.38901912021381685,0.2660669809873377
57,6,1,0,9,10,0.5212277839544482,0.3564901972099899
57,7,1,0,8,9,0.03268796741857406,0.022356712957687572
57,8,1,0,3,4,0.8085544697659599,0.553005329445516
57,9,1,0,2,3,2.202275934147094,1.5062316442891768
57,10,1,0,1,2,2.3911846562648926,1.6354344797396112
57,11,1,0,1,2,0.059290007263542124,0.040550997150622034
57,12,1,0,0,1,0.002584602793409411,0.001767721498922503
57,13,0,0,12,12,0.0664977132063803,0.045480658600170844
57,14,1,1,1,3,0.2897312027487288,0.1981596852381308
57,15,1,2,6,9,9.436137686810449,6.453782182044341
57,16,0,0,8,8,0.030799303579754432,0.021064974172667193
57,17,0,0,11,11,0.18560962452641494,0.12694644009475226
57,18,0,0,16,16,0.141417748871736,0.09672170735373509
57,19,0,0,17,17,0.47042953625030376,0.32174708124525275
57,20,0,0,14,14,0.1431300330852335,0.09789281249382989
57,21,0,0,15,15,0.060931268329138186,0.04167352649184101
57,22,0,1,12,13,0.24670670345749465,0.16873337161987298
57,23,0,0,20,20,0.1648501265880955,0.11274812269527414
57,24,0,0,19,19,0.10649991034164197,0.07283988921790895
57,25,0,0,6,6,0.6247589690457875,0.4272996469875578
57,26,0,0,13,13,0.6926281480828496,0.47371831031329636
57,27,0,1,16,17,1.3221042673571133,0.9042442201114446
57,28,1,0,3,4,1.654126647425389,1.1313286683936832
57,29,0,0,4,4,0.6028571428571429,0.41232004195189986
57,30,0,2,14,16,2.101158121462754,1.4370728041525322
57,31,1,0,5,6,0.7315021626581361,0.5003059281435444
57,32,0,0,7,7,1.0468328621135705,0.7159742150149441
57,33,0,1,10,11,1.3838747274180074,0.9464917060796608
57,34,0,0,24,24,0.4678881020010947,0.32000888457848425
57,35,0,0,22,22,0.6825339723829065,0.46681446750844036
57,36,0,1,17,18,2.1051566497671406,1.4398075703865305
57,37,1,0,6,7,1.8486883424564273,1.2643978162140659
57,38,1,1,7,9,1.9185185185185185,1.3121576901154897
57,39,0,0,18,18,0.1156327190389159,0.07908621160093991
57,40,0,0,5,5,0.7521381010952247,0.5144197378626629
57,41,0,0,2,2,0.4637822688057869,0.31720072789427617
57,42,0,0,1,1,0.04933333333333333,0.03374119774582688
57,43,0,0,3,3,0.6703703703703704,0.4584952546542541
57,44,0,1,13,14,0.2588620813188217,0.1770469596217841
57,45,0,0,21,21,0.5614218692802432,0.3839806684503335
57,46,0,0,1,1,0.09090909090909091,0.06217665432277681
57,47,1,0,2,3,1.9163462141533818,1.3106719573219452
57,48,0,0,23,23,0.3192491190277586,0.21834826328303972
57,49,0,1,9,10,1.5959604838821777,1.0915463165106918
57,50,0,2,15,17,1.8041460292497578,1.2339334040931982
57,51,0,1,15,16,2.580086046678378,1.764632300720754
57,52,0,0,3,3,0.6403961652920089,0.4379946009889239
57,53,1,0,7,8,2.5677414200031903,1.7561892772799588
57,54,0,1,8,9,2.769612181152251,1.8942574111522097
57,55,1,1,8,10,0.07685613556524147,0.05256523110986941
57,56,0,1,14,15,0.9623516627506411,0.6581938733897571
57,58,1,1,9,11,0.06881117150770678,0.04706293266817993
57,59,0,0,10,10,0.5632656707807622,0.38524172394424705
57,60,0,0,9,9,0.6484757377656493,0.4435205696213868
57,61,0,0,8,8,0.9415225140438919,0.6439479188210073
57,62,0,0,7,7,1.026647295418175,0.7021684339849255
57,63,0,0,6,6,1.440901380146703,0.9854946972925293
57,64,0,0,5,5,1.6907284994159308,1.1563622560803664
57,65,0,1,13,14,1.9093643533221325,1.3058967611001677
57,66,0,1,12,13,2.114635824429761,1.4462907874154234
57,67,0,1,11,12,2.3506241783359965,1.6076934167707435
57,68,0,0,4,4,0.6879815080097151,0.47054027244381036
57,69,0,0,2,2,0.11805060555515492,0.08073990863617078
57,70,1,0,5,6,0.20875391793683604,0.14277582213492368
57,71,1,0,6,7,2.5213701192764426,1.724473941586329
57,72,1,0,4,5,0.08737659397334457,0.05976062707320497
57,73,1,0,4,5,8.18824679775317,5.600295697188312
58,0,2,0,0,2,0.000712752076465084,0.0004874819342383201
58,1,1,0,1,2,0.10380116959064327,0.07099410383931094
58,2,1,1,2,4,4.027783764363367,2.754775306840852
58,3,1,1,3,5,4.227274424350697,2.8912155867140545
58,4,1,1,4,6,4.384299467989379,2.998611797155809
58,5,1,0,2,3,0.4128108647909597,0.2823391828487346
58,6,1,0,1,2,0.5616906576033888,0.38416450439553
58,7,1,0,0,1,0.023706190564373265,0.016213687776340007
58,8,1,0,5,6,0.6454705503777526,0.4414651921500702
58,9,1,0,6,7,1.972234448318912,1.3488963349025718
58,10,1,0,7,8,2.191366718814261,1.4987703606716714
58,11,1,0,9,10,0.0614947518443168,0.0420589172089793
58,12,1,0,8,9,0.002854227362298861,0.0019521293887069407
58,13,1,1,28,30,0.0805690547958889,0.05510465696072532
58,14,1,1,9,11,0.29948553027140906,0.204831091193948
58,15,1,2,2,5,9.66675646510015,6.611512326682999
58,16,1,1,8,10,0.03183071472967552,0.021770400812533498
58,17,1,1,27,29,0.17974613617373744,0.12293614712202167
58,18,1,1,32,34,0.15067104939572015,0.10305043930200493
58,19,1,1,33,35,0.45540575153456525,0.3114716658874595
58,20,1,1,30,32,0.20969491051188927,0.14341940760557692
58,21,1,1,31,33,0.10606725484278584,0.07254397743258345
58,22,1,2,28,31,0.297182240301498,0.20325577168704093
58,23,1,1,36,38,0.1850769359542734,0.12658211136942318
58,24,1,1,35,37,0.15998318053956656,0.10941940805253728
58,25,1,1,10,12,0.6545224193558808,0.44765615636277983
58,26,1,1,29,31,0.6554936611020501,0.4483204305482494
58,27,1,2,16,19,1.3644917923345457,0.9332348794807631
58,28,1,0,11,12,1.745186544869481,1.1936084658202202
58,29,1,1,12,14,0.6482330772561515,0.44335460361660156
58,30,1,3,14,18,2.1696013778777172,1.4838841037957538
58,31,1,0,13,14,0.7563032805698235,0.517268484030892
58,32,1,1,9,11,1.0888706363241822,0.7447256647264577
58,33,1,2,10,13,1.43273840390598,0.97991168522092
58,34,1,1,40,42,0.47192316231803033,0.3227686366339585
58,35,1,1,38,40,0.744352450783669,0.5090947952935672
58,36,1,2,17,20,2.197905711506942,1.5032426602426632
58,37,1,0,14,15,1.91469750339119,1.3095443328114158
58,38,1,1,5,7,1.9743945608794051,1.3503737291942641
58,39,1,1,34,36,0.16204710611142004,0.11083101590765708
58,40,1,1,11,13,0.7965115988002431,0.5447686897695351
58,41,1,1,14,16,0.5235757980054931,0.3580961054479551
58,42,1,1,15,17,0.07632969423639939,0.052205175144098385
58,43,1,1,19,21,0.6235793181150219,0.42649283275797645
58,44,1,2,29,32,0.31517250627031024,0.21556009171853513
58,45,1,1,37,39,0.5549866701837375,0.3795793578033951
58,46,1,1,17,19,0.10130362969936615,0.06928592842006083
58,47,1,0,10,11,2.0135176860962067,1.377131724553214
58,48,1,1,39,41,0.43200462960482267,0.2954666277285612
58,49,1,2,9,12,1.6468484676525459,1.1263508068474974
58,50,1,3,15,19,1.866683615195096,1.2767055605917448
58,51,1,2,15,18,2.657734696881587,1.8177395668262208
58,52,1,1,13,15,0.7022470274582615,0.4802970774301687
58,53,1,0,15,16,2.6482605611986147,1.8112597961731811
58,54,1,2,8,11,2.843121408001814,1.9445335468131684
58,55,0,0,1,1,0.08336218337170269,0.05701499825003719
58,56,1,2,14,17,0.9946594223137584,0.6802905457710496
58,57,1,1,16,18,0.07410433854676116,0.05068315825803993
58,59,1,1,26,28,0.6476138502067353,0.4429310874884142
58,60,1,1,25,27,0.7186226109935938,0.49149704639507996
58,61,1,1,24,26,1.018688961486823,0.6967253856287416
58,62,1,1,23,25,1.0921654258320084,0.7469791135976963
58,63,1,1,22,24,1.5139985092361843,1.035488981493754
58,64,1,1,21,23,1.7626467680243059,1.2055502666746776
58,65,1,2,13,16,1.9804932002727327,1.3545448521216445
58,66,1,2,12,15,2.1851663937483905,1.4945296905202674
58,67,1,2,11,14,2.4156112997311654,1.6521409163773608
58,68,1,1,20,22,0.6450110687135344,0.441150932791429
58,69,1,1,18,20,0.15106182424721992,0.10331770710346203
58,70,1,0,3,4,0.21476249049494597,0.14688534446303186
58,71,1,0,2,3,2.5850103249507614,1.768000227347997
58,72,1,0,4,5,0.02196026152894708,0.015019571489154284
58,73,1,0,12,13,8.6599765678721,5.922932064543238
59,0,2,0,0,2,0.0005423899561272664,0.0003709639209129824
59,1,1,0,7,8,0.5250492395414869,0.35910385576348647
59,2,1,1,6,8,3.0663398703694416,2.0972022957172
59,3,1,1,5,7,3.179384440800747,2.174518360683714
59,4,1,1,6,8,3.2421193721636867,2.217425490238197
59,5,1,0,10,11,0.16970050804866688,0.11606550810075722
59,6,1,0,9,10,0.1646347224516587,0.11260079850143394
59,7,1,0,8,9,0.1537077713439809,0.1051273846213703
59,8,1,0,3,4,1.9482403588540524,1.3324857406316615
59,9,1,0,2,3,3.952999574084982,2.7036271686156246
59,10,1,0,1,2,3.9484658493690423,2.700526358436591
59,11,1,0,1,2,0.06919444914119964,0.047325072798380635
59,12,1,0,0,1,0.0009014109111883643,0.0006165138609051202
59,13,0,0,2,2,0.020126178646067514,0.013765162977664913
59,14,1,1,1,3,0.3155309425343453,0.21580524176307736
59,15,1,2,6,9,7.364333152280509,5.036785563998215
59,16,0,0,18,18,0.023052245306509973,0.015766426365653972
59,17,0,0,1,1,0.29442632736373614,0.2013708837802172
59,18,0,0,6,6,0.38083085428782437,0.26046667220752023
59,19,0,0,7,7,0.8388481433071447,0.5737244813928263
59,20,0,0,4,4,0.19732242088489188,0.13495732748842737
59,21,0,0,5,5,0.2418596995402701,0.16541829626218635
59,22,0,1,2,3,0.0620732343265041,0.04245456636757346
59,23,0,0,10,10,0.3955042491694762,0.270502440821799
59,24,0,0,9,9,0.2801676705316142,0.19161877243367978
59,25,0,0,16,16,0.3829030071881619,0.26188390708799075
59,26,0,0,3,3,1.2854928743986895,0.8792041069446808
59,27,0,1,26,27,1.0281926830822274,0.7032253913653327
59,28,1,0,3,4,1.204458402053683,0.8237811308172157
59,29,0,0,14,14,0.24709330634563198,0.16899778603536786
59,30,0,2,24,26,1.5762395915596081,1.0780583463570432
59,31,1,0,5,6,0.6531856318712005,0.446741869656062
59,32,0,0,17,17,0.702087612921475,0.4801880469421429
59,33,0,1,20,21,0.9800733158669842,0.6703144774880304
59,34,0,0,14,14,0.795303721633819,0.5439425703980826
59,35,0,0,12,12,0.34801298844074313,0.23802111610328266
59,36,0,1,27,28,1.497931236166881,1.024499879374817
59,37,1,0,6,7,1.6528815197237128,1.1304770717720403
59,38,1,1,7,9,1.454500843015212,0.9947959574117872
59,39,0,0,8,8,0.14176425764641046,0.09695869967306527
59,40,0,0,15,15,0.3964569425808526,0.27115402899986113
59,41,0,0,12,12,0.051527038599014106,0.035241567539720055
59,42,0,0,11,11,0.11926627538598013,0.08157135774743109
59,43,0,0,7,7,1.136205812709132,0.7771002366197992
59,44,0,1,3,4,0.09946314174212408,0.06802713920153142
59,45,0,0,11,11,0.9840565771025441,0.6730388019141582
59,46,0,0,9,9,0.568424821772718,0.3887702901703314
59,47,1,0,2,3,1.4209310816816165,0.9718361475042794
59,48,0,0,13,13,0.49016323811563023,0.3352438123985333
59,49,0,1,19,20,1.1742807398742574,0.8031413240516193
59,50,0,2,25,27,1.326894804453044,0.9075206753708198
59,51,0,1,25,26,2.0066830490897494,1.3724572210649204
59,52,0,0,13,13,0.16663214632641898,0.1139669229732013
59,53,1,0,7,8,2.7076018909728954,1.851845895005904
59,54,0,1,18,19,2.1555045300187103,1.474242660595681
59,55,1,1,8,10,0.23947729898949074,0.16378886961164016
59,56,0,1,24,25,0.7153108066938526,0.4892319603726532
59,57,0,0,10,10,0.3235166929612583,0.22126704144490086
59,58,1,1,9,11,0.3453940534435922,0.23622991332715426
59,60,0,0,1,1,0.15625,0.10686612461727264
59,61,0,0,2,2,0.3794642857142857,0.25953201692766215
59,62,0,0,3,3,0.53515625,0.3660164768141588
59,63,0,0,4,4,0.8794642857142857,0.6015036157029345
59,64,0,0,5,5,1.1294642857142858,0.7724894150905708
59,65,0,1,23,24,1.3482142857142858,0.9221019895547525
59,66,0,1,22,23,1.5535714285714286,1.0625546104803107
59,67,0,1,21,22,1.8270833333333334,1.2496212171913081
59,68,0,0,6,6,1.149108804016773,0.7859251497527142
59,69,0,0,8,8,0.6746390994752797,0.46141482288774294
59,70,1,0,5,6,0.158492325147023,0.10839974764827554
59,71,1,0,6,7,1.9647016605062253,1.343744335919493
59,72,1,0,4,5,0.5054200825813545,0.34567862738695204
59,73,1,0,4,5,5.908975702143291,4.0414037359723585
60,0,2,0,0,2,0.0005310689781752359,0.00036322101505307136
60,1,1,0,7,8,0.6398383085692986,0.43761305867821826
60,2,1,1,6,8,2.7896361465694612,1.907952666087298
60,3,1,1,5,7,2.877693671635081,1.9681790113490651
60,4,1,1,6,8,2.9132260711549645,1.9924811542933374
60,5,1,0,10,11,0.10764665625512919,0.07362419828475743
60,6,1,0,9,10,0.12704931690339713,0.08689451604952193
60,7,1,0,8,9,0.20035047345349472,0.13702834344454873
60,8,1,0,3,4,2.307143953709975,1.5779554129098066
60,9,1,0,2,3,4.504075871904973,3.080532053840946
60,10,1,0,1,2,4.439100010259079,3.0360922552632514
60,11,1,0,1,2,0.0734827878934418,0.05025805291676905
60,12,1,0,0,1,0.0004335475932626235,0.0002965219272263818
60,13,0,0,3,3,0.03958780855475333,0.02707581236695681
60,14,1,1,1,3,0.3280702254713019,0.22438139902997042
60,15,1,2,6,9,6.700751408942465,4.582933344623428
60,16,0,0,17,17,0.020599439166315767,0.014088846291157935
60,17,0,0,2,2,0.3299708165821917,0.22568129539158852
60,18,0,0,7,7,0.4612811816429371,0.3154901263427641
60,19,0,0,8,8,0.959555155963953,0.6562812215960979
60,20,0,0,5,5,0.2940915917702284,0.20114194364805954
60,21,0,0,6,6,0.31369363510019366,0.21454862784168027
60,22,0,1,3,4,0.1394920237553317,0.09540462076001813
60,23,0,0,11,11,0.4774425503543739,0.3265435845360575
60,24,0,0,10,10,0.36087398731721054,0.24681730879854774
60,25,0,0,15,15,0.30575921205464734,0.2091219331731906
60,26,0,0,4,4,1.4767762565784206,1.010031074990969
60,27,0,1,25,26,0.9360200739999018,0.6401845623829905
60,28,1,0,3,4,1.0765158583734458,0.7362756983898039
60,29,0,0,13,13,0.13520204080092393,0.09247051610074314
60,30,0,2,23,25,1.409719485492691,0.9641680525571802
60,31,1,0,5,6,0.6333043257681307,0.4331441855884473
60,32,0,0,16,16,0.5920782515564328,0.4049478925696425
60,33,0,1,19,20,0.851198885187005,0.5821716872862593
60,34,0,0,15,15,0.9076059697070383,0.6207509290373947
60,35,0,0,13,13,0.2584415842490055,0.17675936351129334
60,36,0,1,26,27,1.3093881858244676,0.8955471426476934
60,37,1,0,6,7,1.6049864961890632,1.0977195962289934
60,38,1,1,7,9,1.3064430920679522,0.893532865806776
60,39,0,0,9,9,0.2022929270625336,0.1383568713770084
60,40,0,0,14,14,0.2832502073181583,0.19372705250003594
60,41,0,0,11,11,0.1450294026059814,0.09919187335718024
60,42,0,0,10,10,0.1722078847078599,0.11778041131050926
60,43,0,0,6,6,1.28423622773014,0.8783446320040017
60,44,0,1,4,5,0.16474189895606406,0.11267410114255924
60,45,0,0,12,12,1.1253117481890273,0.7696493152975968
60,46,0,0,8,8,0.7194901018481656,0.4920903608640016
60,47,1,0,2,3,1.2773195132342139,0.8736139921751138
60,48,0,0,14,14,0.6321550442731593,0.4323581423278909
60,49,0,1,18,19,1.0397146114498752,0.7111057358950501
60,50,0,2,24,26,1.1755262410072362,0.8039931760790615
60,51,0,1,24,25,1.8255306032688345,1.248559238026062
60,52,0,0,12,12,0.053983341721608465,0.03692153935154063
60,53,1,0,7,8,2.7843972417742413,1.9043695527899922
60,54,0,1,17,18,1.9595354478734266,1.3402109399321904
60,55,1,1,8,10,0.32293481690271514,0.22086907127284272
60,56,0,1,23,24,0.636953925907781,0.4356403047777405
60,57,0,0,9,9,0.42566612530258,0.29113145082839753
60,58,1,1,9,11,0.4380175914627619,0.29957915208842967
60,59,0,0,1,1,0.17857142857142858,0.12213271384831159
60,61,0,0,1,1,0.20089285714285715,0.13739930307935055
60,62,0,0,2,2,0.37890625,0.25915035219688615
60,63,0,0,3,3,0.7008928571428571,0.47937090185462305
60,64,0,0,4,4,0.9508928571428571,0.6503567012422593
60,65,0,1,22,23,1.1696428571428572,0.7999692757064409
60,66,0,1,21,22,1.375,0.9404218966319993
60,67,0,1,20,21,1.6604166666666667,1.1356306842662172
60,68,0,0,5,5,1.296143603425443,0.8864886006114828
60,69,0,0,7,7,0.8530991857124618,0.5834713849039472
60,70,1,0,5,6,0.14244829215086321,0.09742654041927556
60,71,1,0,6,7,1.7866180748576799,1.2219452789197605
60,72,1,0,4,5,0.6416381066275156,0.43884401831710057
60,73,1,0,4,5,5.2692407532878205,3.6038613694673134
61,0,2,0,0,2,0.0005310689781752359,0.00036322101505307136
61,1,1,0,7,8,0.7697573207763289,0.5264702833097028
61,2,1,1,6,8,2.4786316727452276,1.6952432718074268
61,3,1,1,5,7,2.5386729874464105,1.7363081205692918
61,4,1,1,6,8,2.5437433874939708,1.7397759861906812
61,5,1,0,10,11,0.0734304913809399,0.05022228507278777
61,6,1,0,9,10,0.21006894955918318,0.14367522906759186
61,7,1,0,8,9,0.2536506639464551,0.17348264616035722
61,8,1,0,3,4,2.7124178777986354,1.855139756434862
61,9,1,0,2,3,5.125192897604375,3.5053408184508785
61,10,1,0,1,2,4.991816195385903,3.41411873025683
61,11,1,0,1,2,0.07856049839579998,0.05373091847398789
61,12,1,0,0,1,0.00042402023816421605,0.0002900057575161775
61,13,0,0,4,4,0.06503708278504049,0.04448167035936009
61,14,1,1,1,3,0.34324157130906197,0.23475773781339318
61,15,1,2,6,9,5.95504571304406,4.07291300653902
61,16,0,0,16,16,0.01784166119436292,0.012202682806886049
61,17,0,0,3,3,0.3699974575891691,0.2530572442291084
61,18,0,0,8,8,0.5519127585882949,0.3774769768778204
61,19,0,0,9,9,1.0954838840951577,0.7492487505531327
61,20,0,0,6,6,0.40411313100292406,0.2763904269903021
61,21,0,0,7,7,0.39478208330638176,0.2700085203922323
61,22,0,1,4,5,0.23643702995893534,0.1617094982894682
61,23,0,0,12,12,0.5701067456090034,0.38992063053695686
61,24,0,0,11,11,0.4528075995632385,0.30969467752046803
61,25,0,0,14,14,0.21916267854570126,0.1498948231482891
61,26,0,0,5,5,1.6919982249334105,1.1572306762108027
61,27,0,1,24,25,0.8326100827415595,0.569458002303086
61,28,1,0,3,4,0.9416600363928581,0.6440419762960938
61,29,0,0,12,12,0.0371703195178791,0.02542238718503366
61,30,0,2,22,24,1.2224321158157527,0.8360741300795039
61,31,1,0,5,6,0.6125710931033872,0.4189638321441633
61,32,0,0,15,15,0.46842082846093536,0.3203732392168474
61,33,0,1,18,19,0.7062840425801292,0.48305816646117883
61,34,0,0,16,16,1.0346393958679991,0.7076345767217234
61,35,0,0,14,14,0.18760285244876632,0.1283096947734123
61,36,0,1,25,26,1.0992275669318923,0.7518092169631041
61,37,1,0,6,7,1.5559361444690765,1.0641719418326467
61,38,1,1,7,9,1.1399062002659097,0.779631091517558
61,39,0,0,10,10,0.2730628786247904,0.1867594983389955
61,40,0,0,13,13,0.15719939588871015,0.10751545747713841
61,41,0,0,10,10,0.30318640541640646,0.20736227957435288
61,42,0,0,9,9,0.2319818000524083,0.15866237410137526
61,43,0,0,5,5,1.450799174307077,0.9922642262792725
61,44,0,1,5,6,0.25679873609722337,0.1756357486932735
61,45,0,0,13,13,1.2846473747885139,0.8786258332377694
61,46,0,0,7,7,0.8896214572704485,0.608450544095126
61,47,1,0,2,3,1.1233939152803387,0.7683376265256608
61,48,0,0,15,15,0.8000624975587844,0.5471973028206301
61,49,0,1,17,18,0.8883690194895026,0.6075939477944928
61,50,0,2,23,25,1.0052894001268222,0.6875608467864078
61,51,0,1,23,24,1.621912196622776,1.1092958139044096
61,52,0,0,11,11,0.17759071354792608,0.12146196047925144
61,53,1,0,7,8,2.8789838485132213,1.969061419048506
61,54,0,1,16,17,1.7390996960460288,1.1894454069729017
61,55,1,1,8,10,0.41891131306251145,0.2865115429460714
61,56,0,1,22,23,0.5488278726824477,0.37536709014729663
61,57,0,0,8,8,0.5407719055021327,0.36985726619462983
61,58,1,1,9,11,0.543300779459639,0.3715868723353289
61,59,0,0,2,2,0.3794642857142857,0.25953201692766215
61,60,0,0,1,1,0.17578125,0.12022439019443172
61,62,0,0,1,1,0.203125,0.1389259620024544
61,63,0,0,2,2,0.5,0.34197159877527245
61,64,0,0,3,3,0.75,0.5129573981629088
61,65,0,1,21,22,0.96875,0.6625699726270904
61,66,0,1,20,21,1.1741071428571428,0.8030225935526487
61,67,0,1,19,20,1.4729166666666667,1.0073913347254901
61,68,0,0,4,4,1.4615635310288648,0.9996264348351469
61,69,0,0,6,6,1.0539118699359242,0.7208158542604501
61,70,1,0,5,6,0.12440300399487664,0.08508458833714913
61,71,1,0,6,7,1.5864051443082736,1.0850110070088343
61,72,1,0,4,5,0.7959875383857666,0.5444102622139483
61,73,1,0,4,5,4.603314420332525,3.1484055839727607
62,0,2,0,0,2,0.000547780071214546,0.0003746504534609418
62,1,1,0,7,8,0.9204734556996481,0.6295515585516172
62,2,1,1,6,8,2.1197966432283013,1.449820494326476
62,3,1,1,5,7,2.147660466065876,1.4688777664139885
62,4,1,1,6,8,2.1178401519860075,1.448482365450242
62,5,1,0,10,11,0.12487753060945928,0.08540913758724962
62,6,1,0,9,10,0.36005673757839124,0.24625835639898233
62,7,1,0,8,9,0.31577211622427437,0.2159701908677325
62,8,1,0,3,4,3.1819512959168277,2.1762739437794547
62,9,1,0,2,3,5.843959402401216,3.9969362800338604
62,10,1,0,1,2,5.6312064609967,3.851425353001371
62,11,1,0,1,2,0.08470097592083878,0.057930656306950185
62,12,1,0,0,1,0.0010421888902757996,0.0007127980020668843
62,13,0,0,5,5,0.09536124849968933,0.06522167722128963
62,14,1,1,1,3,0.36199687696077715,0.2475853015318651
62,15,1,2,6,9,5.094911677350256,3.484630183844544
62,16,0,0,15,15,0.014658273963852284,0.010025426765409032
62,17,0,0,4,4,0.41628692304217096,0.28471660924394
62,18,0,0,9,9,0.6567381280851039,0.44917157527588525
62,19,0,0,10,10,1.2526748240768764,0.8567584246702052
62,20,0,0,7,7,0.5318136786053126,0.3637303478464353
62,21,0,0,8,8,0.48866389451886383,0.33421834654473387
62,22,0,1,5,6,0.35060617701065205,0.23979470978563772
62,23,0,0,13,13,0.677557526258021,0.4634108610333482
62,24,0,0,12,12,0.5597928684393502,0.3828665244064006
62,25,0,0,13,13,0.1198992302620499,0.08200426292927547
62,26,0,0,6,6,1.9407237660377465,1.327344818106192
62,27,0,1,23,24,0.7136541704751264,0.4880989153000396
62,28,1,0,3,4,0.8039086631815964,0.549827861635005
62,29,0,0,11,11,0.15175840090386414,0.10379412596934634
62,30,0,2,21,23,1.0061098073492993,0.6881219587254426
62,31,1,0,5,6,0.5909952232929324,0.4042071627560665
62,32,0,0,14,14,0.3258209071863166,0.2228429930898287
62,33,0,1,17,18,0.5389921029038514,0.3686399823145524
62,34,0,0,17,17,1.182048708734814,0.8084541735125813
62,35,0,0,15,15,0.19391296412133202,0.1326254527276479
62,36,0,1,24,25,0.8608595346336263,0.5887790227591965
62,37,1,0,6,7,1.5062544645586096,1.0301924948149992
62,38,1,1,7,9,0.9475204085159242,0.6480501379447797
62,39,0,0,11,11,0.3562363199448194,0.24364540774669874
62,40,0,0,12,12,0.03869822708605734,0.026467389172775156
62,41,0,0,9,9,0.4899516723635483,0.3350991134415622
62,42,0,0,8,8,0.3011658826774522,0.20598035679154889
62,43,0,0,4,4,1.6432981072861221,1.1239225620260287
62,44,0,1,6,7,0.36928867773854684,0.25257247907171443
62,45,0,0,14,14,1.4691426418291782,1.004810116110503
62,46,0,0,6,6,1.0863438911396086,0.7429975145455249
62,47,1,0,2,3,0.9605047862683685,0.6569307147829907
62,48,0,0,16,16,0.9993457860020226,0.6834957523368859
62,49,0,1,16,17,0.7135704145040374,0.488041630973359
62,50,0,2,22,24,0.8086855080426962,0.5530949521835086
62,51,0,1,22,23,1.3869596334404937,0.9486016065688228
62,52,0,0,10,10,0.3731363949426124,0.25520409907953334
62,53,1,0,7,8,2.998042694826076,2.0504909070923993
62,54,0,1,15,16,1.4844303610247354,1.0152660476603674
62,55,1,1,8,10,0.5310550513162174,0.36321148987258245
62,56,0,1,21,22,0.4470469984676198,0.30575475358731746
62,57,0,0,7,7,0.6739018144283404,0.46091056179523315
62,58,1,1,9,11,0.6657008309833193,0.4553015549547863
62,59,0,0,3,3,0.6116071428571429,0.4183045449304672
62,60,0,0,2,2,0.37890625,0.25915035219688615
62,61,0,0,1,1,0.23214285714285715,0.15877252800280506
62,63,0,0,1,1,0.26785714285714285,0.1831990707724674
62,64,0,0,2,2,0.5178571428571429,0.35418487016010364
62,65,0,1,20,21,0.7366071428571429,0.5037974446242853
62,66,0,1,19,20,0.9419642857142857,0.6442500655498437
62,67,0,1,18,19,1.25625,0.859203641922872
62,68,0,0,3,3,1.6527207452585446,1.1303671111702487
62,69,0,0,5,5,1.285993273302622,0.879546351371087
62,70,1,0,5,6,0.10355924650419025,0.07082864219000096
62,71,1,0,6,7,1.3552986176899338,0.9269472702186867
62,72,1,0,4,5,0.9751011442472753,0.6669137945316767
62,73,1,0,4,5,3.941152082648181,2.6955241574393867
63,0,2,0,0,2,0.0005872688250106898,0.0004016585179995626
63,1,1,0,7,8,1.0948340303362982,0.7488042874953579
63,2,1,1,6,8,1.7069495298721824,1.1674565195181799
63,3,1,1,5,7,1.6981741193886004,1.16145463721222
63,4,1,1,6,8,1.6289275066972733,1.1140938875085697
63,5,1,0,10,11,0.2247158431986087,0.15369287233752332
63,6,1,0,9,10,0.5469430254899158,0.37407796173154223
63,7,1,0,8,9,0.38781533571909765,0.2652436607708577
63,8,1,0,3,4,3.72472473884518,2.5475001478813906
63,9,1,0,2,3,6.674232541306311,4.564795945496938
63,10,1,0,1,2,6.369610683001765,4.356451897684337
63,11,1,0,1,2,0.0920762928483886,0.06297495414932727
63,12,1,0,0,1,0.0018308656380570261,0.001252208098778141
63,13,0,0,6,6,0.13071711821460522,0.08940308380628965
63,14,1,1,1,3,0.38502732371173976,0.263336818923736
63,15,1,2,6,9,4.105864707951298,2.808178237066145
63,16,0,0,14,14,0.010993571327239871,0.0075189783260524255
63,17,0,0,5,5,0.4697319646590478,0.3212699819006087
63,18,0,0,10,10,0.7777659713127255,0.5319477453656308
63,19,0,0,11,11,1.4341539389692994,0.9808798307983716
63,20,0,0,8,8,0.679485805752761,0.4647296946767518
63,21,0,0,9,9,0.597114750273973,0.4083925716069762
63,22,0,1,6,7,0.48315961118096695,0.3304537293983885
63,23,0,0,14,14,0.8018343769479802,0.5484091676757505
63,24,0,0,13,13,0.6837651074910318,0.4676564939909083
63,25,0,0,12,12,0.026130089141404828,0.01787149671965319
63,26,0,0,7,7,2.2277365008805177,1.5236452257122834
63,27,0,1,22,23,0.5775643348175925,0.3950211979462977
63,28,1,0,3,4,0.6837175217837441,0.46762394807010826
63,29,0,0,10,10,0.3207293983076318,0.21936069022698398
63,30,0,2,20,22,0.7567520142762166,0.5175753923968912
63,31,1,0,5,6,0.5696341897988129,0.3895974292051141
63,32,0,0,13,13,0.16270943560159454,0.11128401165699903
63,33,0,1,16,17,0.3465040207853228,0.23698906794003413
63,34,0,0,18,18,1.3526862010026115,0.9251605255962252
63,35,0,0,16,16,0.3036969991355703,0.20771149667528702
63,36,0,1,23,24,0.5990045964511304,0.40968511904425986
63,37,1,0,6,7,1.4592020487234207,0.9980113150762023
63,38,1,1,7,9,0.7256731419284606,0.4963192090671016
63,39,0,0,12,12,0.4530337419207575,0.30984934604757125
63,40,0,0,11,11,0.17104697518110687,0.11698641513671493
63,41,0,0,8,8,0.7065333518183513,0.48322867981874723
63,42,0,0,7,7,0.38106109163171664,0.26062414147269747
63,43,0,0,3,3,1.8654362861601328,1.2758524583831743
63,44,0,1,7,8,0.5017229971116488,0.3431500309291839
63,45,0,0,15,15,1.6823551579708194,1.1506353661582143
63,46,0,0,5,5,1.313423414724007,0.8983070100040926
63,47,1,0,2,3,0.8047169964928319,0.550380715704578
63,48,0,0,17,17,1.2328714450420204,0.8432140382908003
63,49,0,1,15,16,0.5121222082750856,0.35026250066430814
63,50,0,2,21,23,0.5821422560596117,0.3981522360386988
63,51,0,1,21,22,1.1166008779600511,0.7636915748597431
63,52,0,0,9,9,0.6024113281504786,0.41201513001590895
63,53,1,0,7,8,3.1469254837062794,2.152318277779368
63,54,0,1,14,15,1.190704840869463,0.8143744762031733
63,55,1,1,8,10,0.6612560331651826,0.4522615657225841
63,56,0,1,20,21,0.3297456874282772,0.22552731983819843
63,57,0,0,6,6,0.8275946388534909,0.566027723573145
63,58,1,1,9,11,0.8074658715926316,0.5522607901300022
63,59,0,0,4,4,0.8794642857142857,0.6015036157029345
63,60,0,0,3,3,0.61328125,0.41944953912279515
63,61,0,0,2,2,0.5,0.34197159877527245
63,62,0,0,1,1,0.234375,0.16029918692590894
63,64,0,0,1,1,0.25,0.17098579938763622
63,65,0,1,19,20,0.46875,0.32059837385181794
63,66,0,1,18,19,0.6741071428571429,0.46105099477737627
63,67,0,1,17,18,1.00625,0.6882178425352358
63,68,0,0,2,2,1.873291645326898,1.2812250778496
63,69,0,0,4,4,1.5538023227435545,1.0627125289786905
63,70,1,0,5,6,0.07952922286692996,0.054393470986317985
63,71,1,0,6,7,1.0891850802460583,0.7449407265078359
63,72,1,0,4,5,1.1823158852960816,0.8086369071042053
63,73,1,0,4,5,3.4041214814341454,2.328225730862567
64,0,2,0,0,2,0.0006402631116564719,0.000437903599859989
64,1,1,0,7,8,1.2578410750854097,0.8602918469043301
64,2,1,1,6,8,1.3237867144793751,0.9053949183759541
64,3,1,1,5,7,1.281876610531645,0.8767307878722678
64,4,1,1,6,8,1.177867174689192,0.8055942417467521
64,5,1,0,10,11,0.3247044778854142,0.2220794188639304
64,6,1,0,9,10,0.725140732294534,0.49595507111966725
64,7,1,0,8,9,0.45525197616245044,0.3113664922677508
64,8,1,0,3,4,4.2319353562529916,2.8944033993828753
64,9,1,0,2,3,7.449770715876819,5.095220004435204
64,10,1,0,1,2,7.059229679658555,4.828112119349381
64,11,1,0,1,2,0.09918197793643156,0.06783483912923059
64,12,1,0,0,1,0.002578052640155157,0.0017632415661613422
64,13,0,0,7,7,0.16385624722980763,0.11206836566898724
64,14,1,1,1,3,0.40765311404965476,0.27881157431455783
64,15,1,2,6,9,3.188923973868162,2.1810428594329805
64,16,0,0,13,13,0.007592366940689023,0.005192747722391898
64,17,0,0,6,6,0.5196374876993085,0.355402524904197
64,18,0,0,11,11,0.8907705061822692,0.6092364282820185
64,19,0,0,12,12,1.6036037526174078,1.096773878169203
64,20,0,0,9,9,0.8174685554817025,0.5591020577331807
64,21,0,0,10,10,0.6984042219638128,0.4776688167527306
64,22,0,1,7,8,0.6071843538054754,0.4152796084443782
64,23,0,0,15,15,0.9180032868798575,0.62786210339052
64,24,0,0,14,14,0.7997612490959758,0.5469912659837195
64,25,0,0,11,11,0.11048026749319016,0.07556222741553201
64,26,0,0,8,8,2.495629292177663,1.706868677992794
64,27,0,1,21,22,0.4526257951824178,0.30957033365092085
64,28,1,0,3,4,0.6292454639775943,0.430368154677012
64,29,0,0,9,9,0.48001062913401477,0.32830000454816677
64,30,0,2,19,21,0.5245699296672571,0.35877603503548827
64,31,1,0,5,6,0.553481836862362,0.3785501372897929
64,32,0,0,12,12,0.03741894685180751,0.02559243415879912
64,33,0,1,15,16,0.16904733988367926,0.11561877817745733
64,34,0,0,19,19,1.5123114405163571,1.034335122319028
64,35,0,0,17,17,0.43970783299261534,0.30073518128499027
64,36,0,1,22,23,0.391944963775587,0.2680680917885075
64,37,1,0,6,7,1.4261307122066478,0.9753923994316506
64,38,1,1,7,9,0.5189052790389981,0.3549017357717901
64,39,0,0,13,13,0.5437795815276102,0.371914345752691
64,40,0,0,10,10,0.32847038386737126,0.22465508464290485
64,41,0,0,7,7,0.9090250454697744,0.6217214962521268
64,42,0,0,6,6,0.4556631309299546,0.31164769877412574
64,43,0,0,2,2,2.0727815086114845,1.4176648128233806
64,44,0,1,8,9,0.6263701400851002,0.42840159645998616
64,45,0,0,16,16,1.8815735110675376,1.2868894035859373
64,46,0,0,4,4,1.5254162241156426,1.0432980499171312
64,47,1,0,2,3,0.7097045551182236,0.48539760274374477
64,48,0,0,18,18,1.452733974270582,0.9935875195529329
64,49,0,1,14,15,0.3247456856401872,0.2221076026274937
64,50,0,2,20,22,0.3715067244706419,0.25408949704598005
64,51,0,1,20,21,0.8656077977375968,0.5920265650093373
64,52,0,0,8,8,0.8171606202515762,0.5588914475272496
64,53,1,0,7,8,3.2955976696192755,2.2540016079995318
64,54,0,1,13,14,0.9167878969851418,0.6270308457396575
64,55,1,1,8,10,0.7831926063646187,0.5356592554949625
64,56,0,1,19,20,0.22059694971893412,0.15087578316066458
64,57,0,0,5,5,0.9710850868440218,0.664167039389749
64,58,1,1,9,11,0.9400782762796298,0.6429601422264947
64,59,0,0,5,5,1.1294642857142858,0.7724894150905708
64,60,0,0,4,4,0.83203125,0.5690621135869769
64,61,0,0,3,3,0.75,0.5129573981629088
64,62,0,0,2,2,0.453125,0.30991176139009063
64,63,0,0,1,1,0.25,0.17098579938763622
64,65,0,1,18,19,0.21875,0.14961257446418172
64,66,0,1,17,18,0.42410714285714285,0.29006519538974
64,67,0,1,16,17,0.7729166666666667,0.5286310964401086
64,68,0,0,1,1,2.0791611372903107,1.4220281164611628
64,69,0,0,3,3,1.8037703214237062,1.2336764412813037
64,70,1,0,5,6,0.05714428280002714,0.03908344349998316
64,71,1,0,6,7,0.8418108858894857,0.5757508290281118
64,72,1,0,4,5,1.3760211205604351,0.9411202850931878
64,73,1,0,4,5,3.2255050956208713,2.206062268814515
65,0,3,0,0,3,0.0006965969133895024,0.00047643272034745627
65,1,2,0,7,9,1.4006130275878492,0.9579397526193831
65,2,2,1,6,9,0.992181044622725,0.6785954762083065
65,3,2,1,5,8,0.9235668792960252,0.6316672845775015
65,4,2,1,6,9,0.7943563310876426,0.5432946090786015
65,5,2,0,10,12,0.4137769633818787,0.2829999394081569
65,6,2,0,9,11,0.8822764454867602,0.6034269732497438
65,7,2,0,8,10,0.5143544636077746,0.3517892365142967
65,8,2,0,3,5,4.676079890302973,3.198173032175617
65,9,2,0,2,4,8.128717691722871,5.559581170062625
65,10,2,0,1,3,7.662903392393666,5.240990648714642
65,11,2,0,1,3,0.1055404952107825,0.07218370376553056
65,12,2,0,0,2,0.0032346560503474925,0.0022123210020508805
65,13,1,0,20,21,0.1929078875773854,0.131938037462398
65,14,2,1,1,4,0.4282071592778345,0.2928693737305176
65,15,2,2,6,10,2.3970033375028916,1.6394141271910556
65,16,1,0,0,1,0.0046642784794743404,0.003190101537517874
65,17,1,0,19,20,0.5633185653983445,0.38527790085812946
65,18,1,0,24,25,0.9896732375025985,0.676880278587727
65,19,1,0,25,26,1.751911588772685,1.1982080138510454
65,20,1,0,22,23,0.9382732293683145,0.6417255926702409
65,21,1,0,23,24,0.7870662773437425,0.5383086264106832
65,22,1,1,20,22,0.7158255184327437,0.4895839939651673
65,23,1,0,28,29,1.0197443170825822,0.697447188909458
65,24,1,0,27,28,0.9013998565502931,0.6165063001606099
65,25,1,0,2,3,0.20380735267989314,0.13939265247619773
65,26,1,0,21,22,2.730043501438288,1.8671946818257883
65,27,0,0,3,3,0.34670476436121705,0.237126365143219
65,28,2,0,3,5,0.6394508606220471,0.4373480662902907
65,29,1,0,4,5,0.6196855687214546,0.4238297293472795
65,30,0,1,1,2,0.3227755067810719,0.2207601121988439
65,31,2,0,5,7,0.5426119317944457,0.3711157396605714
65,32,1,0,1,2,0.13603628237053872,0.09304108994739506
65,33,0,0,3,3,0.04541976722686685,0.031064540829144754
65,34,1,0,32,33,1.652189526618186,1.1300037877947633
65,35,1,0,30,31,0.5670222876495756,0.38781103649747556
65,36,0,0,4,4,0.30684886021575236,0.20986719062070186
65,37,2,0,6,8,1.4063866912685248,0.961888610618726
65,38,2,1,7,10,0.3386256820409859,0.23160073174784604
65,39,1,0,26,27,0.6233638715388222,0.4263454795377492
65,40,1,0,3,4,0.4673971303232791,0.3196730878392523
65,41,1,0,6,7,1.0863298314165448,0.742987898493576
65,42,1,0,7,8,0.520955105764616,0.35630370081693374
65,43,1,0,11,12,2.2542179637865294,1.541757042128037
65,44,1,1,21,23,0.7358499673838569,0.5032795796099793
65,45,1,0,29,30,2.0560140752317384,1.4061968408229217
65,46,1,0,9,10,1.710936042266173,1.1701830675520006
65,47,2,0,2,4,0.6834476530389466,0.4674393731778725
65,48,1,0,31,32,1.64602916134557,1.1257904478721308
65,49,0,0,4,4,0.16303042819766642,0.1115035523595465
65,50,0,1,2,3,0.18993294512944922,0.12990334581202767
65,51,0,0,2,2,0.6482653267638934,0.443376660448046
65,52,1,0,5,6,1.0052892662690376,0.6875607552352867
65,53,2,0,7,9,3.432401491667314,2.347567651488203
65,54,0,0,5,5,0.6775043607129645,0.4633744988204628
65,55,2,1,8,11,0.8900834660216268,0.6087665318377032
65,56,0,0,1,1,0.12602902090374943,0.08619669154107484
65,57,1,0,8,9,1.0966605516516863,0.7500535243241989
65,58,2,1,9,12,1.0562630401454574,0.7224239211315437
65,59,1,0,18,19,1.3482142857142858,0.9221019895547525
65,60,1,0,17,18,1.0234375,0.6999731162431359
65,61,1,0,16,17,0.96875,0.6625699726270904
65,62,1,0,15,16,0.64453125,0.44082276404624965
65,63,1,0,14,15,0.46875,0.32059837385181794
65,64,1,0,13,14,0.21875,0.14961257446418172
65,66,0,0,1,1,0.20535714285714285,0.14045262092555832
65,67,0,0,2,2,0.56875,0.3889926936068724
65,68,1,0,12,13,2.2592988654753188,1.5452320902755077
65,69,1,0,10,11,2.0224988096285688,1.3832743028995342
65,70,2,0,5,7,0.03765140838157836,0.02575142464077809
65,71,2,0,6,8,0.6270692785506565,0.42887976745764933
65,72,2,0,4,6,1.5456654845481463,1.0571473938453717
65,73,2,0,4,6,3.3683569477550073,2.3037648213391537
66,0,3,0,0,3,0.0007560201701580185,0.0005170748525905823
66,1,2,0,7,9,1.534729142191747,1.0496675568846285
66,2,2,1,6,9,0.6886214198502274,0.47097793579416075
66,3,2,1,5,8,0.601605309631386,0.41146385913267575
66,4,2,1,6,9,0.46842082846093525,0.3203732392168473
66,5,2,0,10,12,0.49800044897853235,0.34060401945598445
66,6,2,0,9,11,1.0303378447772193,0.7046925601142684
66,7,2,0,8,10,0.5698935830937416,0.38977483948467073
66,8,2,0,3,5,5.093240131912329,3.483486941712877
66,9,2,0,2,4,8.76632350845771,5.995667331137078
66,10,2,0,1,3,8.229786495673213,5.628706491009031
66,11,2,0,1,3,0.11160850472091721,0.07633387759265921
66,12,2,0,0,2,0.0038521947110813155,0.0026346823682842522
66,13,1,0,20,21,0.22020853244316166,0.1506101278070889
66,14,2,1,1,4,0.4480546587446674,0.306443935979246
66,15,2,2,6,10,1.6753316421267495,1.1458316802737742
66,16,1,0,0,1,0.002136005320524571,0.0014609063089045516
66,17,1,0,19,20,0.6043343656538193,0.4133303784349533
66,18,1,0,24,25,1.0825352008010503,0.7403925866968915
66,19,1,0,25,26,1.8911646340534665,1.2934491869090339
66,20,1,0,22,23,1.0517199824600976,0.7193167277315623
66,21,1,0,23,24,0.8703197209756749,0.5952492528554011
66,22,1,1,20,22,0.8178751451697378,0.5593801419845066
66,23,1,0,28,29,1.1153132345270145,0.762810899892847
66,24,1,0,27,28,0.9968984018500137,0.6818218805943264
66,25,1,0,2,3,0.2922713126420354,0.19989697612068866
66,26,1,0,21,22,2.950110962265998,2.0177083246611214
66,27,0,0,4,4,0.2539027637062314,0.17365506807616035
66,28,2,0,3,5,0.696565001201181,0.4764108942233349
66,29,1,0,4,5,0.7509191646487222,0.5135860545718312
66,30,0,1,2,3,0.1397542485937369,0.09558396765447413
66,31,2,0,5,7,0.5353553041030519,0.3661526185138857
66,32,1,0,1,2,0.26024675432719563,0.17799399730669327
66,33,0,0,2,2,0.1504848217651393,0.1029230701808732
66,34,1,0,32,33,1.7836363374738828,1.2199059399192302
66,35,1,0,30,31,0.689606760819455,0.4716518530473319
66,36,0,0,5,5,0.37459087969253196,0.25619888403018176
66,37,2,0,6,8,1.3960079891957962,0.9547901679366795
66,38,2,1,7,10,0.17170371968171722,0.11743559107043608
66,39,1,0,26,27,0.6981757695189091,0.47751256825707505
66,40,1,0,3,4,0.5981040273472479,0.4090691809317352
66,41,1,0,6,7,1.252838878806324,0.8568706287864368
66,42,1,0,7,8,0.5822580565732383,0.3982314370122666
66,43,1,0,11,12,2.424552197987945,1.658255982920077
66,44,1,1,21,23,0.8388369817440101,0.5737168475176464
66,45,1,0,29,30,2.219854747960059,1.5182545544175619
66,46,1,0,9,10,1.8851129555393578,1.2893101825555464
66,47,2,0,2,4,0.7131819348681108,0.48777593296898014
66,48,1,0,31,32,1.8280142231394152,1.2502578929418469
66,49,0,0,3,3,0.04548571072763063,0.031109642437914815
66,50,0,1,3,4,0.05544424684963805,0.03792071547612317
66,51,0,0,3,3,0.449057783099217,0.3071300160578375
66,52,1,0,5,6,1.1819963555846458,0.8084183669316536
66,53,2,0,7,9,3.5658609058683153,2.4388463099800584
66,54,0,0,4,4,0.4537492261657966,0.3103386966299203
66,55,2,1,8,11,0.9905413123200577,0.6774739924540932
66,56,0,0,2,2,0.04372373160976031,0.029904548806021294
66,57,1,0,8,9,1.2145600632622218,0.8306900932847561
66,58,2,1,9,12,1.1654220766658083,0.7970825016108092
66,59,1,0,18,19,1.5535714285714286,1.0625546104803107
66,60,1,0,17,18,1.203125,0.8228691595529993
66,61,1,0,16,17,1.1741071428571428,0.8030225935526487
66,62,1,0,15,16,0.82421875,0.5637188073561131
66,63,1,0,14,15,0.6741071428571429,0.46105099477737627
66,64,1,0,13,14,0.42410714285714285,0.29006519538974
66,65,0,0,1,1,0.20535714285714285,0.14045262092555832
66,67,0,0,1,1,0.3770833333333333,0.25790358074301795
66,68,1,0,12,13,2.428409012939603,1.6608938252704748
66,69,1,0,10,11,2.227839601966855,1.523715740998944
66,70,2,0,5,7,0.019676958543801637,0.013457921944517207
66,71,2,0,6,8,0.42917554148409165,0.2935316921531162
66,72,2,0,4,6,1.7050131466492902,1.1661321433850318
66,73,2,0,4,6,3.7296416497878684,2.550863035673604
67,0,3,0,0,3,0.0008863094169212187,0.0006061852966282574
67,1,2,0,7,9,1.798756643024718,1.2302473700456098
67,2,2,1,6,9,0.2571555064067434,0.1758797593195577
67,3,2,1,5,8,0.3237694794902743,0.22143993307185372
67,4,2,1,6,9,0.5034034835763708,0.3442993882153062
67,5,2,0,10,12,0.6645355456023059,0.4545045659452371
67,6,2,0,9,11,1.3224791605310051,0.9045006257475361
67,7,2,0,8,10,0.6792652542145108,0.46457884995245624
67,8,2,0,3,5,5.914378752925606,4.0450991158009435
67,9,2,0,2,4,10.021220732482435,6.8539457511338515
67,10,2,0,1,3,9.3454282628592,6.3917420885791545
67,11,2,0,1,3,0.12377051945694752,0.08465200483987662
67,12,2,0,0,2,0.005068767310827393,0.003466748922206964
67,13,1,0,20,21,0.27396637588101697,0.18737743914139723
67,14,2,1,1,4,0.48840535197389484,0.33404151812982497
67,15,2,2,6,10,0.6754628043053148,0.46197819020303493
67,16,1,0,0,1,0.004168349310198923,0.0028509141557250595
67,17,1,0,19,20,0.6850479521518542,0.4685338868701918
67,18,1,0,24,25,1.2652598796309695,0.8653658878072228
67,19,1,0,25,26,2.1651827934208283,1.480862043013662
67,20,1,0,22,23,1.2749835255397637,0.872016309281933
67,21,1,0,23,24,1.0341493877357224,0.7072994389929081
67,22,1,1,20,22,1.0187477183190385,0.696765571964445
67,23,1,0,28,29,1.3034480348344881,0.8914844167856738
67,24,1,0,27,28,1.184939216238772,0.8104311164573823
67,25,1,0,2,3,0.46688165547789773,0.31932053232524527
67,26,1,0,21,22,3.3830804935153123,2.313834890305738
67,27,0,0,5,5,0.14809204721637473,0.1012865483049736
67,28,2,0,3,5,0.9036969263214123,0.6180773654048658
67,29,1,0,4,5,1.0092551304637232,0.6902731810736511
67,30,0,1,3,4,0.2597157233292671,0.17763080226797162
67,31,2,0,5,7,0.529831096741383,0.36237437446701354
67,32,1,0,1,2,0.5082495313118036,0.34761380959896077
67,33,0,0,1,1,0.4378193052123779,0.29944353555631165
67,34,1,0,32,33,2.0425213778740563,1.3969686022485266
67,35,1,0,30,31,0.9348470694235911,0.639382293882327
67,36,0,0,6,6,0.7207180626939033,0.49293021633130224
67,37,2,0,6,8,1.3992174787708325,0.9569852764991348
67,38,2,1,7,10,0.1770432355958092,0.12108751665809217
67,39,1,0,26,27,0.8455420561417063,0.578302737541021
67,40,1,0,3,4,0.8555658016582943,0.5851584101010691
67,41,1,0,6,7,1.580524321500578,1.0809888582535108
67,42,1,0,7,8,0.7028804228948825,0.4807302839304051
67,43,1,0,11,12,2.7596793118002045,1.8874638927267189
67,44,1,1,21,23,1.0418097052997015,0.7125386610818688
67,45,1,0,29,30,2.5423611324025197,1.7388306022236035
67,46,1,0,9,10,2.2278170072961925,1.5237002875276435
67,47,2,0,2,4,0.8971042341581297,0.6135683384462439
67,48,1,0,31,32,2.187034521904032,1.4958073840644712
67,49,0,0,2,2,0.3064204305478285,0.20957416906369652
67,50,0,1,4,5,0.3396969190117012,0.23233339698693137
67,51,0,0,4,4,0.16377834749269518,0.1120150866736982
67,52,1,0,5,6,1.5297940941231931,1.046292264328556
67,53,2,0,7,9,3.8406416130641508,2.626780705484778
67,54,0,0,3,3,0.06880229827263824,0.04705686387941453
67,55,2,1,8,11,1.1883886050157333,0.812790302447092
67,56,0,0,3,3,0.14804895436088367,0.10125707523959747
67,57,1,0,8,9,1.4465379558990747,0.9893497949358423
67,58,2,1,9,12,1.3803493141320944,0.9440805236442062
67,59,1,0,18,19,1.9575892857142858,1.338879875562116
67,60,1,0,17,18,1.556640625,1.0646537664995788
67,61,1,0,16,17,1.578125,1.0793478586344538
67,62,1,0,15,16,1.177734375,0.8055034143026926
67,63,1,0,14,15,1.078125,0.7373762598591813
67,64,1,0,13,14,0.828125,0.5663904604715451
67,65,0,0,2,2,0.609375,0.4167778860073633
67,66,0,0,1,1,0.40401785714285715,0.276325265081805
67,68,1,0,12,13,2.761117528162331,1.8884475510242011
67,69,1,0,10,11,2.631832739108891,1.8000240990043441
67,70,2,0,5,7,0.01872753703219317,0.012808571560044437
67,71,2,0,6,8,0.1384108571243526,0.09466516419734135
67,72,2,0,4,6,2.0186851710054605,1.3806659907053433
67,73,2,0,4,6,4.868760116013297,3.3299553618526962
68,0,2,0,0,2,0.0008916268245728301,0.0006098221014201802
68,1,1,0,7,8,0.41136724321344437,0.28135182769095585
68,2,1,1,6,8,5.230126857763822,3.577109686693973
68,3,1,1,5,7,5.53923365675544,3.7885211791809126
68,4,1,1,6,8,5.815746872617498,3.9776405122025933
68,5,1,0,10,11,0.7354694328621887,0.5030193156124512
68,6,1,0,9,10,1.1267052442278556,0.7706023874341671
68,7,1,0,8,9,0.2362431705447111,0.16157690946182843
68,8,1,0,3,4,0.9661416832256622,0.660786032112225
68,9,1,0,2,3,0.6190301305018486,0.4233814468355655
68,10,1,0,1,2,0.4059551369742563,0.2776502544442423
68,11,1,0,1,2,0.05006320188848207,0.034240386379226904
68,12,1,0,0,1,0.005074244816070564,0.0034704952246575782
68,13,0,0,8,8,0.17458699645467804,0.11940758860595815
68,14,1,1,1,3,0.26466483821408665,0.18101571572734007
68,15,1,2,6,9,12.554840810531122,8.586797968692728
68,16,0,0,12,12,0.04224828897580248,0.028895429853149784
68,17,0,0,7,7,0.038301906390717226,0.02619632832914879
68,18,0,0,12,12,0.2577262384751921,0.17627010763539713
68,19,0,0,13,13,0.15023703340897623,0.10275359702024327
68,20,0,0,10,10,0.5836529923031989,0.39918549381579344
68,21,0,0,11,11,0.3303676852325523,0.22595273100532373
68,22,0,1,8,9,0.6536696035592322,0.4470728787998983
68,23,0,0,16,16,0.2790286505848857,0.19083974748924043
68,24,0,0,15,15,0.3931280913144665,0.26887728382055887
68,25,0,0,10,10,0.9865670098212361,0.6747557952950161
68,26,0,0,9,9,0.22320715190044588,0.1526610131869411
68,27,0,1,20,21,1.7534208740481274,1.1992402792483474
68,28,1,0,3,4,2.31885057977714,1.5859620801747119
68,29,0,0,8,8,1.1373187229405046,0.7778614040020309
68,30,0,2,18,20,2.878413583372696,1.9686713900848436
68,31,1,0,5,6,0.8466634676145205,0.5790697192895073
68,32,0,0,11,11,1.5621201129616031,1.0684014250169773
68,33,0,1,14,15,1.987264341489389,1.3591759280964304
68,34,0,0,20,20,0.23362616809399822,0.15978702843769022
68,35,0,0,18,18,1.1839021194317805,0.809721801151039
68,36,0,1,21,22,2.9947258905393936,2.048222401362916
68,37,1,0,6,7,2.140141440706931,1.4637351801675282
68,38,1,1,7,9,2.6112398182095453,1.7859397108375397
68,39,0,0,14,14,0.3909635984969084,0.267396893681843
68,40,0,0,9,9,1.2850779404791852,0.8789203157130028
68,41,0,0,6,6,1.1416723584273465,0.780839043377871
68,42,0,0,5,5,0.29881246441353293,0.2043707523789501
68,43,0,0,1,1,0.03414646095293662,0.023354239689186294
68,44,0,1,9,10,0.660628241082804,0.4518321915983652
68,45,0,0,17,17,0.22980276592001628,0.15717203852929532
68,46,0,0,3,3,0.6179933239065136,0.42267233001751053
68,47,1,0,2,3,2.644544469542702,1.808718200563645
68,48,0,0,19,19,0.8778519237320153,0.6004008516931716
68,49,0,1,13,14,2.2257324841702064,1.5222745921154888
68,50,0,2,19,21,2.5106708103243065,1.7171562220100236
68,51,0,1,19,20,3.4257780982591965,2.3430376266220194
68,52,0,0,7,7,1.3599635067327984,0.9301377893468822
68,53,1,0,7,8,2.4320296050829646,1.6633701046380318
68,54,0,1,12,13,3.6864830979783596,2.5213450377473583
68,55,1,1,8,10,0.4672609595551585,0.31957995476869094
68,56,0,1,18,19,1.3280894574817625,0.908337750183245
68,57,0,0,4,4,0.4798230004580577,0.3281716771915806
68,58,1,1,9,11,0.41772145402400324,0.2856977469506397
68,59,0,0,6,6,1.39534640487751,0.9543376818425815
68,60,0,0,5,5,1.377152578639533,0.9418941381497005
68,61,0,0,4,4,1.774755716249336,1.2138320994426783
68,62,0,0,3,3,1.7560157918372037,1.2010150556183892
68,63,0,0,2,2,2.274711283611233,1.5557733088173715
68,64,0,0,1,1,2.5246956667096634,1.7267484271314117
68,65,0,1,17,18,2.743434336648601,1.8763532524774023
68,66,0,1,16,17,2.948782372855232,2.016799644971291
68,67,0,1,15,16,3.1292665319173083,2.1402405578274277
68,69,0,0,2,2,0.7209821428571429,0.4931108321625581
68,70,1,0,5,6,0.283847379825251,0.19413548457402618
68,71,1,0,6,7,3.3567666071929723,2.295837686754455
68,72,1,0,4,5,0.5988576807538162,0.40958463705246845
68,73,1,0,4,5,11.571871429522181,7.914502747151196
69,0,2,0,0,2,0.000674749964284223,0.0004614906481196675
69,1,1,0,7,8,0.11784206158705635,0.08059727640779955
69,2,1,1,6,8,4.109808821512591,2.8108757867067586
69,3,1,1,5,7,4.317206495383709,2.9527240149387155
69,4,1,1,6,8,4.482772158648113,3.0659615240763487
69,5,1,0,10,11,0.43764538886144955,0.29932458665115147
69,6,1,0,9,10,0.606650001361964,0.41491414172554414
69,7,1,0,8,9,0.05491457595187536,0.03755845066865789
69,8,1,0,3,4,0.6160558362587192,0.4213471985204633
69,9,1,0,2,3,1.8746012950577249,1.282120803874173
69,10,1,0,1,2,2.0943490206873827,1.4324157659957808
69,11,1,0,1,2,0.05654415276394461,0.03867298864415876
69,12,1,0,0,1,0.00290901230626381,0.0019895991784599555
69,13,0,0,10,10,0.07976246001938926,0.05455299195015859
69,14,1,1,1,3,0.28129533716881056,0.19239003235929492
69,15,1,2,6,9,9.866768721319053,6.748309348750654
69,16,0,0,10,10,0.03233623766128566,0.022116149782814072
69,17,0,0,9,9,0.1620209776352357,0.11081314551410842
69,18,0,0,14,14,0.08995004792280074,0.061520723396145095
69,19,0,0,15,15,0.39030079521287386,0.26694357388441337
69,20,0,0,12,12,0.1920933700724436,0.1313809537556072
69,21,0,0,13,13,0.0583378340148718,0.03989976473430436
69,22,0,1,10,11,0.2978793359154543,0.2037325454902487
69,23,0,0,18,18,0.11713077330725498,0.08011079562733198
69,24,0,0,17,17,0.10248644896874036,0.07009490961328103
69,25,0,0,8,8,0.674237318512141,0.4611400275310989
69,26,0,0,11,11,0.5670714408268119,0.3878446544786843
69,27,0,1,18,19,1.3790129804603721,0.9431665473197741
69,28,1,0,3,4,1.7335227765888133,1.1856311108468518
69,29,0,0,6,6,0.6760102040046195,0.46235258050371564
69,30,0,2,16,18,2.2059027504503557,1.508712180628558
69,31,1,0,5,6,0.7422951158999703,0.5076876950947781
69,32,0,0,9,9,1.1172709445882791,0.7641498623720252
69,33,0,1,12,13,1.46635613415528,1.002904303142018
69,34,0,0,22,22,0.39403719260466635,0.2694990574638754
69,35,0,0,20,20,0.7448964734597954,0.5094668759022171
69,36,0,1,19,20,2.22117440114913,1.5191571222393527
69,37,1,0,6,7,1.8746984782707665,1.2821872716716487
69,38,1,1,7,9,2.0131299123245245,1.3768665093198833
69,39,0,0,16,16,0.1408194355119924,0.09631249500133485
69,40,0,0,7,7,0.8250630597256942,0.5642962672496274
69,41,0,0,4,4,0.5569142307460615,0.38089769973786325
69,42,0,0,3,3,0.08385437111776319,0.05735162671087301
69,43,0,0,1,1,0.5765091723370511,0.3942995267454208
69,44,0,1,11,12,0.3059106645952237,0.20922551810806958
69,45,0,0,19,19,0.46758443524312554,0.319801193765049
69,46,0,0,1,1,0.0271170853471143,0.01854654606055638
69,47,1,0,2,3,2.004335578467616,1.370851684501462
69,48,0,0,21,21,0.33614877658560655,0.22990666911066346
69,49,0,1,11,12,1.6820077546568697,1.150397762024832
69,50,0,2,17,19,1.8993152870069305,1.2990237705521508
69,51,0,1,17,18,2.6931386647866082,1.841953869841158
69,52,0,0,5,5,0.7391022861208808,0.505503980886433
69,53,1,0,7,8,2.5132807244715027,1.7189412550371896
69,54,0,1,10,11,2.894873474886544,1.97992902091816
69,55,1,1,8,10,0.1295531183135257,0.08860697399199682
69,56,0,1,16,17,1.0116226720490276,0.691892445035838
69,57,0,0,2,2,0.06780342472911463,0.04637369111410835
69,58,1,1,9,11,0.08056630626518396,0.055102777121846414
69,59,0,0,8,8,0.6746390994752797,0.46141482288774294
69,60,0,0,7,7,0.7464617874984041,0.5105374617909538
69,61,0,0,6,6,1.0539118699359242,0.7208158542604501
69,62,0,0,5,5,1.1252441141397942,0.7696030574497011
69,63,0,0,4,4,1.5538023227435545,1.0627125289786905
69,64,0,0,3,3,1.8037703214237062,1.2336764412813037
69,65,0,1,15,16,2.0224988096285688,1.3832743028995342
69,66,0,1,14,15,2.227839601966855,1.523715740998944
69,67,0,1,13,14,2.4563772231682983,1.6800224924040543
69,68,0,0,2,2,0.59375,0.40609127354563607
69,70,1,0,5,6,0.21902156403126896,0.14979830883606748
69,71,1,0,6,7,2.6362920691236944,1.803074027433602
69,72,1,0,4,5,0.09553344786248336,0.06533945180409514
69,73,1,0,4,5,8.589097011115841,5.874454473854398
70,0,1,0,0,1,0.0008402865803120777,0.0005747082905974551
70,1,0,0,2,2,1.6679646377023174,1.1407930677113591
70,2,0,1,1,2,0.3494718788912814,0.2390189143028998
70,3,0,1,0,1,0.24386997883060413,0.16679321310798706
70,4,0,1,1,2,0.1847990064049413,0.12639202334475916
70,5,0,0,5,5,0.580559768923427,0.3970699047266941
70,6,0,0,4,4,1.1760744630713142,0.8043681288305349
70,7,0,0,3,3,0.6249199030402172,0.42740971669830263
70,8,0,0,2,2,5.50817761706692,3.76728061209309
70,9,0,0,3,3,9.401262084468456,6.429929251062058
70,10,0,0,4,4,8.794708541996597,6.015081081738243
70,11,0,0,6,6,0.11879833428922272,0.08125131261744953
70,12,0,0,5,5,0.004496063691074266,0.003075052177264239
70,13,0,1,25,26,0.24858175522473938,0.17001580052113513
70,14,0,1,6,7,0.4732876346452599,0.3237018582004131
70,15,0,2,1,3,0.8652632868413843,0.5917909391253906
70,16,0,1,5,6,0.0026385143537430277,0.001804593943882016
70,17,0,1,24,25,0.6466015085366232,0.442238703289544
70,18,0,1,29,30,1.1778817286974554,0.8056041958617011
70,19,0,1,30,31,2.0343836198171545,1.3914028379821965
70,20,0,1,27,28,1.1686318284884756,0.799277789535748
70,21,0,1,28,29,0.9559700387987403,0.6538292050985288
70,22,0,2,25,27,0.9233761188108146,0.6315368152412804
70,23,0,1,33,34,1.2145002473011046,0.830649182565045
70,24,0,1,32,33,1.0963055462299025,0.7498107207808762
70,25,0,1,7,8,0.38106412383497357,0.2606262153274886
70,26,0,1,26,27,3.174503229463577,2.17117988939385
70,27,0,2,13,15,0.20855633003206137,0.14264068323153478
70,28,0,0,8,8,0.8386954801854091,0.5736200684891982
70,29,0,1,9,10,0.8828860374374718,0.6038438995177146
70,30,0,3,11,14,0.14448784070333084,0.09882147577780988
70,31,0,0,10,10,0.5446098744592976,0.3724822189552929
70,32,0,1,6,7,0.38571428370660354,0.2638066605392124
70,33,0,2,7,9,0.29358826386362913,0.20079769595020358
70,34,0,1,37,38,1.9213337558513943,1.3140831525388006
70,35,0,1,35,36,0.8255341050749964,0.5646184355120205
70,36,0,2,14,16,0.5821606820870185,0.39816483839480166
70,37,0,0,11,11,1.4296047796367428,0.9777684642182959
70,38,0,1,2,3,0.011857637476727497,0.008109950491228179
70,39,0,1,31,32,0.7763660672428301,0.5309902904998025
70,40,0,1,8,9,0.7293669868398699,0.4988455891670668
70,41,0,1,11,12,1.4203002532154123,0.9714046966659977
70,42,0,1,12,13,0.6440086265812835,0.4404653193141379
70,43,0,1,16,17,2.5963128070484682,1.77573048309416
70,44,0,2,26,28,0.9468872675902616,0.6476171055155819
70,45,0,1,34,35,2.3898235034309585,1.6345035285180152
70,46,0,1,14,15,2.060627819905168,1.4093523801075487
70,47,0,0,7,7,0.8471818068684484,0.5794242338962547
70,48,0,1,36,37,2.021172926792757,1.3823674743532317
70,49,0,2,6,8,0.15502847721510218,0.10603067241788879
70,50,0,3,12,15,0.20328772972320464,0.13903725988967952
70,51,0,2,12,14,0.3123656736096122,0.213640377613588
70,52,0,1,10,11,1.3596276247953,0.92990806518055
70,53,0,0,12,12,3.745765075388471,2.561890542934349
70,54,0,2,5,7,0.2207107502912299,0.15095361628796367
70,55,0,1,3,4,1.0900347190220308,0.7455218311690375
70,56,0,2,11,13,0.08388513961032247,0.057372670612057815
70,57,0,1,13,14,1.3333487425145092,0.9119348024053716
70,58,0,1,4,5,1.273746104340263,0.8711699834700295
70,59,0,1,23,24,1.762519562237653,1.205463265142207
70,60,0,1,22,23,1.3860886552648448,0.9480059069703728
70,61,0,1,21,22,1.3834280488894541,0.9461862033385647
70,62,0,1,20,21,1.00768001188257,0.689195889434736
70,63,0,1,19,20,0.8844075632210826,0.6048845367273129
70,64,0,1,18,19,0.6354750377449446,0.4346288292788307
70,65,0,2,10,12,0.4187038316004986,0.28636963741150995
70,66,0,2,9,11,0.21881832023486553,0.14965930162407304
70,67,0,2,8,10,0.19437622811330493,0.1329422989836279
70,68,0,1,17,18,2.599499349796692,1.777909897330512
70,69,0,1,15,16,2.4356371250084417,1.6658374433510899
70,71,0,0,1,1,0.2103668822023824,0.14387899807223625
70,72,0,0,1,1,1.863728013528394,1.2746840969371351
70,73,0,0,9,9,4.495458856089931,3.074638504491062
71,0,1,0,0,1,0.0009232409654648623,0.0006314443780296902
71,1,0,0,1,1,1.7969002003495,1.228977668706252
71,2,0,1,0,1,0.04224140646040429,0.02889072260356116
71,3,0,1,1,2,0.16653748437106522,0.11390217957277023
71,4,0,1,2,3,0.4044101530465898,0.27659357319658984
71,5,0,0,4,4,0.6615979925805741,0.4524954465385796
71,6,0,0,3,3,1.3184067126304093,0.9017153027085444
71,7,0,0,2,2,0.6782600761845133,0.4638913652765122
71,8,0,0,3,3,5.909386356250368,4.04168460005544
71,9,0,0,4,4,10.014430656480517,6.849301724841487
71,10,0,0,5,5,9.339965146653935,6.388005627413135
71,11,0,0,7,7,0.1257275707742708,0.0859905167756172
71,12,0,0,6,6,0.005117459123871721,0.003500051356515034
71,13,0,1,26,27,0.2759403693614087,0.18872753855432028
71,14,0,1,7,8,0.4977440725441176,0.3404286725376542
71,15,0,2,0,2,0.15920810978785666,0.10888930368428487
71,16,0,1,6,7,0.005149023532685841,0.0035216396192081566
71,17,0,1,25,26,0.6872761695004893,0.4700578609684549
71,18,0,1,30,31,1.2697616563000378,0.8684448473369237
71,19,0,1,31,32,2.1722734194845454,1.485711628476316
71,20,0,1,28,29,1.2813898965822026,0.8763979031773937
71,21,0,1,29,30,1.0385381500854673,0.7103011031476821
71,22,0,2,26,28,1.025172674404502,0.7011598769736588
71,23,0,1,34,35,1.3099943013022783,0.8959616912056722
71,24,0,1,33,34,1.1920326506760535,0.8152826226880316
71,25,0,1,8,9,0.4683428003674887,0.3203198724331167
71,26,0,1,27,28,3.390709278516012,2.319052545912542
71,27,0,2,14,16,0.2203567902077933,0.15071152769669277
71,28,0,0,9,9,0.9910011865194888,0.677788520284523
71,29,0,1,10,11,1.0113085078052015,0.6916775745383598
71,30,0,3,12,15,0.31833442408190094,0.2177226638969865
71,31,0,0,11,11,0.5570260049088013,0.38097414691613113
71,32,0,1,7,8,0.5105456954703401,0.3491842554556512
71,33,0,2,8,10,0.44052340924120037,0.3012929891122938
71,34,0,1,38,39,2.053760077630094,1.404655234495982
71,35,0,1,36,37,0.9561821669638861,0.6539742887140892
71,36,0,2,15,17,0.7980597372432298,0.5458275285264823
71,37,0,0,12,12,1.4707984321859717,1.0059425826616017
71,38,0,1,3,4,0.1846752237621629,0.12630736304825604
71,39,0,1,32,33,0.8516697413980395,0.5824937261888208
71,40,0,1,9,10,0.8575758862506372,0.5865331937845031
71,41,0,1,12,13,1.5827207135729482,1.0824910656705622
71,42,0,1,13,14,0.7037426928770045,0.48132002761912945
71,43,0,1,17,18,2.7619158228203986,1.8889935392252275
71,44,0,2,27,29,1.0509677278212106,0.7188022282884696
71,45,0,1,35,36,2.5533741182512015,1.74636285897953
71,46,0,1,15,16,2.2302091355091243,1.5253363673465468
71,47,0,0,8,8,1.0002169903464837,0.6840916066219566
71,48,0,1,37,38,2.2069608061766752,1.5094358306452036
71,49,0,2,7,9,0.3103584552306335,0.21226755425728713
71,50,0,3,13,16,0.3786221228238569,0.25895602534752377
71,51,0,2,13,15,0.3045793739591083,0.20831499093353567
71,52,0,1,11,12,1.5321649995345856,1.0479138289567138
71,53,0,0,13,13,3.9211044362526226,2.6818127060602457
71,54,0,2,6,8,0.08336936937105367,0.05701991306541092
71,55,0,1,2,3,1.1865332159858546,0.8115213217412967
71,56,0,2,12,14,0.17168063570671802,0.11741980294276295
71,57,0,1,14,15,1.4481715556869823,0.9904670843983018
71,58,0,1,3,4,1.3786721733070728,0.9429334545855984
71,59,0,1,24,25,1.9647016605062253,1.343744335919493
71,60,0,1,23,24,1.5632908155004699,1.0692021190547902
71,61,0,1,22,23,1.5864051443082736,1.0850110070088343
71,62,0,1,21,22,1.185886290478692,0.8110788614413509
71,63,0,1,20,21,1.0891850802460583,0.7449407265078359
71,64,0,1,19,20,0.8418108858894857,0.5757508290281118
71,65,0,2,11,13,0.6270692785506565,0.42887976745764933
71,66,0,2,10,12,0.42917554148409165,0.2935316921531162
71,67,0,2,9,11,0.12918346664939578,0.08835415325085191
71,68,0,1,18,19,2.7643960294530356,1.8906898596801396
71,69,0,1,16,17,2.6362920691236944,1.803074027433602
71,70,0,0,1,1,0.018916973750836476,0.012938135515126823
71,72,0,0,2,2,2.017364099251947,1.3797624526660515
71,73,0,0,10,10,5.2978381988251035,3.623420397809861
72,0,1,0,0,1,0.0007052759473097737,0.0004823686865585363
72,1,0,0,3,3,0.0995119068727581,0.06806049178090622
72,2,0,1,2,3,4.041815814353803,2.7643724319794996
72,3,0,1,1,2,4.242628850585451,2.901717142089606
72,4,0,1,2,3,4.401061181804755,3.0100758572991237
72,5,0,0,6,6,0.416744422005923,0.2850295125480847
72,6,0,0,5,5,0.5685736125983696,0.38887205464339364
72,7,0,0,4,4,0.027600721301177453,0.018877325581428742
72,8,0,0,1,1,0.6292623255687292,0.4303796870475686
72,9,0,0,2,2,1.9465390503895261,1.331322142280414
72,10,0,0,3,3,2.168152211350393,1.4828929562072728
72,11,0,0,5,5,0.060570059071709856,0.04142647987733063
72,12,0,0,4,4,0.002858232115276547,0.001954868412263899
72,13,0,1,24,25,0.07999975641261102,0.054715289204105885
72,14,0,1,5,6,0.29608625658366333,0.20250618107860174
72,15,0,2,2,4,9.701034452286233,6.634956522844645
72,16,0,1,4,5,0.03191197564822695,0.021825978665003465
72,17,0,1,23,24,0.17621661646498424,0.1205221561265993
72,18,0,1,28,29,0.13882918827093874,0.09495127893937245
72,19,0,1,29,30,0.44229190631850557,0.30250254065820475
72,20,0,1,26,27,0.20379721011381702,0.13938571553712426
72,21,0,1,27,28,0.09592900213676614,0.06560998845925287
72,22,0,2,24,26,0.29573302942241336,0.20226459376447478
72,23,0,1,32,33,0.17225022173828655,0.11780936743447408
72,24,0,1,31,32,0.1483268959277297,0.10144717148355836
72,25,0,1,6,7,0.6576473432315499,0.449793426790407
72,26,0,1,25,26,0.6370018744224175,0.4356730988381589
72,27,0,2,12,14,1.3667358634405087,0.9347696966485065
72,28,0,0,7,7,1.7420546300846709,1.1914664140078415
72,29,0,1,8,9,0.6522629368402825,0.4461107986662518
72,30,0,3,10,13,2.175498825301657,1.4879176228442694
72,31,0,0,9,9,0.7535706783792875,0.5153995393510632
72,32,0,1,5,6,1.0934748051424366,0.747874654670077
72,33,0,2,6,8,1.438269316376735,0.9836945151815403
72,34,0,1,36,37,0.4568988108091335,0.31249283362184027
72,35,0,1,34,35,0.743387776199252,0.5084350126737052
72,36,0,2,13,15,2.201067655959329,1.5054052506419064
72,37,0,0,10,10,1.9069241566902964,1.3042278052131375
72,38,0,1,3,4,1.9808799710062213,1.3548093813338253
72,39,0,1,30,31,0.1567371671901546,0.1071993193030487
72,40,0,1,7,8,0.800881507992436,0.5477574594354488
72,41,0,1,10,11,0.5275970710657759,0.3608464278030288
72,42,0,1,11,12,0.0756982313018093,0.051773290365480194
72,43,0,1,15,16,0.6133097374240885,0.4194690229027161
72,44,0,2,25,27,0.3119206747639262,0.21333602368016324
72,45,0,1,33,34,0.5378054424023162,0.3678283739367256
72,46,0,1,13,14,0.077373856878089,0.052919323080018406
72,47,0,0,6,6,2.010808467866705,1.3752787731744662
72,48,0,1,35,36,0.4122572012712452,0.281960508450694
72,49,0,2,5,7,1.6526894097967528,1.130345679494314
72,50,0,3,11,14,1.8719413758082304,1.2803015701974472
72,51,0,2,11,13,2.663450195169559,1.821648643000891
72,52,0,1,9,10,0.7072427501871671,0.4837138680074523
72,53,0,0,11,11,2.6230127716044387,1.7939917422270568
72,54,0,2,4,6,2.8518555056431736,1.9505071734817183
72,55,0,1,4,5,0.08905237063266207,0.060906763119959136
72,56,0,2,10,12,0.9974038772860377,0.6821675970803239
72,57,0,1,12,13,0.06452425401108523,0.04413092460790521
72,58,0,1,5,6,0.015058465048420854,0.01029913473542008
72,59,0,1,22,23,0.6498258204617414,0.44444394949750976
72,60,0,1,21,22,0.7218428699559551,0.4936995206067381
72,61,0,1,20,21,1.0234125493531285,0.6999560514179335
72,62,0,1,19,20,1.0969887872781847,0.7502780188481362
72,63,0,1,18,19,1.5201204239521047,1.0396760234196925
72,64,0,1,17,18,1.7691700121491307,1.2100117951198128
72,65,0,2,9,11,1.9872841944190454,1.3591895063726207
72,66,0,2,8,10,2.1921597599776588,1.499312755780755
72,67,0,2,7,9,2.4224222052065527,1.656799188846412
72,68,0,1,16,17,0.6340846031510994,0.4336778509967313
72,69,0,1,14,15,0.12282871868033575,0.08400786660526519
72,70,0,0,1,1,0.2154771850245594,0.14737415492488756
72,71,0,0,2,2,2.59375384189536,1.7739802962849232
72,73,0,0,8,8,8.641755076131684,5.910469599218157
73,0,1,0,0,1,0.0004203737223045416,0.00028751174779919307
73,1,0,0,11,11,1.384465872034885,0.9468960154191428
73,2,0,1,10,11,1.9114070850431328,1.3072938735651667
73,3,0,1,9,10,1.978335514908946,1.3530691178946281
73,4,0,1,10,11,2.0218058580558314,1.3828003633851285
73,5,0,0,14,14,0.4926688107250951,0.3369574817407458
73,6,0,0,13,13,0.9707154237821859,0.6639142108532206
73,7,0,0,12,12,0.5153226097337925,0.35245139347142157
73,8,0,0,7,7,4.596407598322559,3.1436817100423515
73,9,0,0,6,6,7.940986645519623,5.431183798042866
73,10,0,0,5,5,7.469992808705337,5.109050767265504
73,11,0,0,3,3,0.08958932720533973,0.06127401091522207
73,12,0,0,4,4,0.0031907729150142013,0.0021823074301524858
73,13,0,1,24,25,0.1823472339992179,0.12471515028592255
73,14,0,1,3,4,0.3572355106678092,0.24432879744474323
73,15,0,2,10,12,4.630252272944867,3.16682954502359
73,16,0,1,4,5,0.011502986837565897,0.007867389599066651
73,17,0,1,23,24,0.5312391205368592,0.36333738276391875
73,18,0,1,28,29,0.9359118694867478,0.6401105566422746
73,19,0,1,29,30,1.6533635749922373,1.130806770193791
73,20,0,1,26,27,0.8900027314922745,0.6087113140055452
73,21,0,1,27,28,0.7441232070705678,0.5089380056154104
73,22,0,2,24,26,0.6844453463197521,0.46812173871052126
73,23,0,1,32,33,0.9507957650334564,0.6502902957544987
73,24,0,1,31,32,0.8373458087745004,0.5726969699087789
73,25,0,1,6,7,0.36035496286557184,0.24646232555548708
73,26,0,1,25,26,2.600803076802931,1.778801572547892
73,27,0,2,12,14,0.48927178106908237,0.33463410641563834
73,28,0,0,1,1,0.06142229709533103,0.04200936227628025
73,29,0,1,8,9,0.6963183062892065,0.47624216891641963
73,30,0,3,10,13,0.813306223933451,0.556255259384804
73,31,0,0,1,1,0.41761134829784835,0.28562244088822475
73,32,0,1,5,6,0.4903890787891268,0.33539827459090144
73,33,0,2,6,8,0.5988477489569459,0.4095778442675595
73,34,0,1,36,37,1.5280934017410208,1.045129087342643
73,35,0,1,34,35,0.4897187558962217,0.33493981180813664
73,36,0,2,13,15,0.5465986641515577,0.37384243813667273
73,37,0,0,2,2,1.057489142346009,0.7232625053911128
73,38,0,1,11,12,0.8372848698983926,0.5726552911789986
73,39,0,1,30,31,0.576892847920628,0.3945619390508745
73,40,0,1,7,8,0.602212083902694,0.4118788582679856
73,41,0,1,10,11,1.1129869234763936,0.7612198352743882
73,42,0,1,11,12,0.5125747641943454,0.3505720232067972
73,43,0,1,15,16,2.1722380094781677,1.4856874100433288
73,44,0,2,25,27,0.6817566079458881,0.4662827943897239
73,45,0,1,33,34,1.9220143159228147,1.314548616970173
73,46,0,1,13,14,1.6645572480949675,1.1384626067680077
73,47,0,0,2,2,0.19376120039310699,0.13252165495809348
73,48,0,1,35,36,1.4835053083828182,1.0146333641985517
73,49,0,2,5,7,0.6809342901062857,0.46572037569710345
73,50,0,3,11,14,0.677662525106623,0.4634826742816001
73,51,0,2,11,13,1.0332139138317569,0.7066596279798049
73,52,0,1,9,10,1.0644504374219639,0.7280236358044543
73,53,0,0,3,3,2.848860122926361,1.9484585018484937
73,54,0,2,4,6,1.267242193812129,0.866721678106835
73,55,0,1,12,13,0.896397506430736,0.6130849768245727
73,56,0,2,10,12,0.366274562287438,0.25051099531229654
73,57,0,1,12,13,1.0707707350907991,0.7323463604015485
73,58,0,1,13,14,1.0515685832416122,0.7192131792659645
73,59,0,1,22,23,1.345347146470124,0.920141029172278
73,60,0,1,21,22,1.049731556319058,0.7179567571985663
73,61,0,1,20,21,1.0480760510578517,0.7168244856366554
73,62,0,1,19,20,0.7851513914650673,0.5369989532398778
73,63,0,1,18,19,0.7750455158622385,0.5300871083660309
73,64,0,1,17,18,0.7343783923065377,0.5022731058461619
73,65,0,2,9,11,0.7669026979263632,0.5245178834298966
73,66,0,2,8,10,0.8491594827642022,0.5807768518721153
73,67,0,2,7,9,1.0346115246528256,0.7076155143936979
73,68,0,1,16,17,2.169725893035409,1.4839692650908491
73,69,0,1,14,15,1.9555533373522673,1.3374874025293493
73,70,0,0,9,9,0.09203869998417762,0.06294924276557372
73,71,0,0,10,10,1.2062042327682154,0.8249751798584951
73,72,0,0,8,8,1.5303107947316523,1.046645658194882
