source,destination,hamming_distance_ups,hamming_distance_downs,hamming_distance_LR,hamming_distance_total,fitts_ratio,normalized_fitts_ratio
0,1,0,1,3,4,1.1614040976895261,0.7943344322220799
0,2,0,2,4,6,3.4232325263972285,2.3412966000631505
0,3,0,2,5,7,3.610915531187356,2.4696611144852048
0,4,0,2,6,8,3.7727091687127294,2.5803187722776424
0,5,0,1,0,1,0.5939246123705618,0.40621069848869
0,6,0,1,1,2,1.0385170520494775,0.7102866732894852
0,7,0,2,2,4,0.4462997547326014,0.30524368131783935
0,8,0,1,6,7,3.8096061704005204,2.605554225592018
0,9,0,1,7,8,6.51627976733449,4.456765220204672
0,10,0,1,8,9,6.121294047580841,4.186617424049558
0,11,0,1,10,11,0.05849614480133854,0.04000804031980716
0,12,0,1,11,12,0.00018331819388100494,0.00012537923169216524
0,13,0,1,9,10,0.0034697022857740544,0.002373079275880741
0,14,0,3,28,31,0.15886780985797688,0.1086565578621167
0,15,0,2,10,12,0.2378436836977153,0.1626715695454158
0,16,0,3,4,7,8.253391558760692,5.6448510133354635
0,17,0,3,6,9,8.337989332908892,5.702711085492043
0,18,0,1,2,3,0.2867428347617378,0.19611581128165048
0,19,0,2,9,11,0.024856349070270563,0.01700033086255336
0,20,0,2,28,30,0.006071486805931985,0.004152552099935067
0,21,0,2,29,31,0.412076786994975,0.281837115333698
0,22,0,3,32,35,0.7294027450267835,0.4988700457357631
0,23,0,3,33,36,1.2793945135867109,0.8750331745511191
0,24,0,3,30,33,0.7302143006398981,0.49942510367678683
0,25,0,3,31,34,0.5882250840238796,0.4023125448467301
0,26,0,4,28,32,0.6058317412990442,0.41435449832168275
0,27,0,3,36,39,0.722638184834261,0.4942434708076661
0,28,0,3,35,38,0.6429243964214524,0.43972376747174224
0,29,0,2,11,13,0.6248727371377982,0.42737745790018683
0,30,0,3,29,32,2.0453146374827362,1.3988790331568761
0,31,0,3,17,20,1.0073281676977517,0.688955247997932
0,32,0,2,12,14,0.9067456781169903,0.6201625384564714
0,33,0,2,13,15,0.8397181256899514,0.5743194999255357
0,34,0,4,15,19,1.716774116782856,1.174175978904479
0,35,0,1,12,13,0.43339459045682865,0.29641728199815226
0,36,0,2,10,12,0.9661775995241347,0.6608105968202466
0,37,0,3,11,14,1.226302955474551,0.8387215645329479
0,38,0,3,40,43,1.1397328414709014,0.7795125239489766
0,39,0,3,38,41,0.6145264411834371,0.4203011791623568
0,40,0,3,18,21,1.565047778130353,1.0704037816938494
0,41,0,1,13,14,1.0532947940952597,0.7203938094368548
0,42,0,2,7,9,1.634458334323403,1.1178766594402856
0,43,0,3,34,37,0.45541358521478986,0.311477023679761
0,44,0,2,12,14,0.8637613302786685,0.5907636861513048
0,45,0,2,15,17,1.0871738913086948,0.7435651875151371
0,46,0,2,16,18,0.4394946593026536,0.3005893825898442
0,47,0,2,20,22,1.745108782833661,1.1935552810047936
0,48,0,4,29,33,0.5776884338718684,0.3951060746502922
0,49,0,3,37,40,1.4620464149225068,0.99995669998941
0,50,0,2,18,20,1.3698982907155617,0.9369326172710272
0,51,0,2,11,13,1.0975687304472352,0.7506746670335741
0,52,0,3,39,42,1.0921172098268577,0.7469461365889604
0,53,0,3,10,13,1.3798070586815334,0.9437096517174602
0,54,0,4,16,20,1.4823460863277023,1.0138405221595046
0,55,0,3,16,19,2.0431413687977056,1.3973926408232997
0,56,0,2,14,16,1.1337888123481892,0.7754471456644553
0,57,0,1,14,15,1.968016260095429,1.3460113337611326
0,58,0,3,9,12,2.343552551595868,1.6028568257662166
0,59,0,3,2,5,0.787098186584568,0.5383304505188848
0,60,0,3,15,18,0.7878083908831303,0.5388161899177576
0,61,0,2,17,19,0.892635513020769,0.6105119870225959
0,62,0,3,16,19,0.5908461504941189,0.40410520542937817
0,63,0,3,3,6,0.897622994812592,0.6139231412670204
0,64,0,2,27,29,1.2807618688126967,0.8759683678565673
0,65,0,2,26,28,1.0972756374142691,0.7504742080474275
0,66,0,2,25,27,1.254029299902022,0.85768480919706
0,67,0,2,24,26,1.1318034972971855,0.7740893029403266
0,68,0,2,23,25,1.3867357043013582,0.9484484517573778
0,69,0,2,22,24,1.5118727221131738,1.0340350638515305
0,70,0,3,14,17,1.6448954382786456,1.1250150456926018
0,71,0,3,13,16,1.7852133784064375,1.2209845463373097
0,72,0,3,12,15,1.9533447098644816,1.3359768267831549
0,73,0,2,21,23,1.7338798137349396,1.1858753039742178
0,74,0,2,19,21,1.5933075741453944,1.089731876942503
0,75,0,1,5,6,0.17842613537419097,0.12203334155441056
0,76,0,1,4,5,2.1800769187100597,1.4910487786886977
0,77,0,2,3,5,1.2953029479796427,0.885913640037844
0,78,0,2,13,15,4.3598359985945025,2.9818801736746976
1,0,1,0,0,1,0.0007509390541232015,0.0005135996578426042
1,2,0,1,1,2,4.2743111968552,2.923386067303242
1,3,0,1,2,3,4.496213716779988,3.0751547863251245
1,4,0,1,3,4,4.677687775603417,3.1992727343892966
1,5,0,0,3,3,0.47867228279827223,0.32738465167586905
1,6,0,0,2,2,0.6769499984400058,0.46299534651489394
1,7,0,1,1,2,0.0666914554464694,0.04561316728735798
1,8,0,0,3,3,0.3227592813832133,0.22074901494835097
1,9,0,0,4,4,1.4791829680896207,1.0116771289575208
1,10,0,0,5,5,1.7530972873945885,1.1990189643578415
1,11,0,0,7,7,0.05928539353524289,0.04054784162253642
1,12,0,0,8,8,0.0014075755646214465,0.0009627017324612056
1,13,0,0,6,6,0.003315464142794885,0.00226758914718731
1,14,0,2,25,27,0.09965661707348195,0.06815946533830748
1,15,0,1,7,8,0.29355934143962753,0.20077791465505102
1,16,0,2,1,3,10.258417952534831,7.016175176266586
1,17,0,2,3,5,10.291009475899722,7.038465926969812
1,18,0,0,1,1,0.043153294700656666,0.029514402362408106
1,19,0,1,6,7,0.03399800274981495,0.02325270271104066
1,20,0,1,25,26,0.00423374739951216,0.002895642734043651
1,21,0,1,26,27,0.1505735473980088,0.10298375347392268
1,22,0,2,29,31,0.11866430045480537,0.08115964108815817
1,23,0,2,30,32,0.3614200133901989,0.24719075961685338
1,24,0,2,27,29,0.28055131127186583,0.19188116090827817
1,25,0,2,28,30,0.13134057971014493,0.08982949605509874
1,26,0,3,25,28,0.3698514883798498,0.25295740958134266
1,27,0,2,33,35,0.15983729248659226,0.1093196289111016
1,28,0,2,32,34,0.18561845293354978,0.12695247822375735
1,29,0,1,8,9,0.7230246782893457,0.49450781037716907
1,30,0,2,26,28,0.49965648326453843,0.34173665284080873
1,31,0,2,14,16,1.4460600807620936,0.9890229554866256
1,32,0,1,9,10,1.8681382962097601,1.2777004797763303
1,33,0,1,10,11,0.749127383516778,0.5123605780551385
1,34,0,3,12,15,2.3167987447361744,1.5845587415559477
1,35,0,0,9,9,0.7774350143905872,0.531721389630052
1,36,0,1,7,8,1.1864942137031003,0.8114946463953179
1,37,0,2,8,10,1.5470995991257268,1.0581282467552158
1,38,0,2,37,39,0.39647883721300325,0.27116900368458347
1,39,0,2,35,37,0.8364501896425671,0.572084417295897
1,40,0,2,15,17,2.365390502726863,1.6177927438907016
1,41,0,0,10,10,1.9677835555479446,1.3458521770688414
1,42,0,1,4,5,2.10574040688298,1.4402068270949306
1,43,0,2,31,33,0.20364617108391173,0.1392824134200559
1,44,0,1,9,10,0.8973058739978849,0.6137062486429997
1,45,0,1,12,13,0.6507633699457092,0.4450851800894364
1,46,0,1,13,14,0.1206942878147558,0.08254803713410984
1,47,0,1,17,18,0.4939413448236544,0.33782782278110646
1,48,0,3,26,29,0.3847661685542576,0.26315820363027087
1,49,0,2,34,36,0.45226541444382057,0.309323853696229
1,50,0,1,15,16,0.13662643027932905,0.0934447175951609
1,51,0,1,8,9,2.148781348746825,1.469644386498876
1,52,0,2,36,38,0.4971116574774726,0.3399961365547938
1,53,0,2,7,9,1.7662371883812045,1.2080059102541252
1,54,0,3,13,16,2.000439360028111,1.3681868924035918
1,55,0,2,13,15,2.8178747999919644,1.9272663010036062
1,56,0,1,11,12,0.8377930468493472,0.5730028553477561
1,57,0,0,11,11,2.615510657596333,1.7888607223839643
1,58,0,2,6,8,3.0170005614091706,2.063457010981977
1,59,0,2,1,3,0.16119912808400869,0.11025104710413673
1,60,0,2,12,14,1.0639111611699426,0.7276548014802836
1,61,0,1,14,15,0.14333769086537113,0.09803483861997347
1,62,0,2,13,15,0.18454769367204082,0.12622013971063406
1,63,0,2,2,4,0.08452380952380953,0.05780948455486749
1,64,0,1,24,25,0.8016376782285201,0.5482746369246089
1,65,0,1,23,24,0.8547839903542973,0.5846236955779323
1,66,0,1,22,23,1.1752544808281449,0.8038073075532071
1,67,0,1,21,22,1.2296950072237487,0.8410415352525511
1,68,0,1,20,21,1.6715769570313124,1.1432636889438055
1,69,0,1,19,20,1.9204537842821878,1.313481301970004
1,70,0,2,11,13,2.1384359617635913,1.4625687294456655
1,71,0,2,10,12,2.3432025295963284,1.6026174306006382
1,72,0,2,9,11,2.563228216310223,1.7531025023149938
1,73,0,1,18,19,0.5172338131580808,0.3537585480525989
1,74,0,1,16,17,0.17991957617309495,0.1230547702297654
1,75,0,0,2,2,0.22900196952797774,0.15662433928433755
1,76,0,0,1,1,2.7434815558907544,1.8763855477568667
1,77,0,1,2,3,0.11817038941140025,0.08082183398982615
1,78,0,1,10,11,9.284065259528052,6.349773279869546
2,0,2,0,0,2,0.00093195324178108,0.000637403080151348
2,1,1,0,1,2,1.7997099776232421,1.2308993967592596
2,3,1,1,1,3,0.16670970518685901,0.114019968828209
2,4,1,1,2,4,0.40911177841417684,0.2798092178841821
2,5,1,0,4,5,0.6632815234728707,0.453646886040232
2,6,1,0,3,4,1.3214375458388896,0.9037882204643948
2,7,1,1,2,4,0.6794006973956321,0.46467148539483877
2,8,1,0,2,3,5.918183563747823,4.047701390280765
2,9,1,0,3,4,10.027799419028664,6.858445199045962
2,10,1,0,4,5,9.351870187000728,6.39614799877489
2,11,1,0,6,7,0.1262425766824771,0.08634275156323325
2,12,1,0,7,8,0.0016513065351137191,0.001129399871761788
2,13,1,0,5,6,0.005142781846226701,0.003517370660213184
2,14,1,2,24,27,0.2769957280567302,0.18944934395496124
2,15,1,1,6,8,0.4999971094840719,0.341969621826566
2,16,0,1,0,1,0.058333333333333334,0.03989668652378178
2,17,1,2,2,5,0.9022469655126913,0.6170856745730263
2,18,1,0,2,3,0.43960801805107513,0.30066691353471
2,19,1,1,5,7,0.005437180487988473,0.003718722608614268
2,20,1,1,24,26,0.010774606956644875,0.007369219134278041
2,21,1,1,25,27,0.6886383201430107,0.4709894946344466
2,22,1,2,28,31,1.272805032096283,0.8705263435103556
2,23,1,2,29,32,2.176838277230487,1.4888337318794387
2,24,1,2,26,29,1.2853707720510228,0.8791205958745892
2,25,1,2,27,30,1.0413641652763443,0.712233937013657
2,26,1,3,24,28,1.0289374838536172,0.703734792786455
2,27,1,2,32,35,1.3134933410354404,0.8983548356291274
2,28,1,2,31,34,1.1956699946519989,0.8177703593575308
2,29,1,1,7,9,0.4712495144721239,0.32230789977220614
2,30,1,2,25,28,3.3972454323395627,2.323522903858304
2,31,1,2,13,16,0.23440775479159404,0.1603215893428069
2,32,1,1,8,10,1.010888155807368,0.6913900776488646
2,33,1,1,9,11,1.0151756659086453,0.6943224910170626
2,34,1,3,11,15,0.3371654720690652,0.2306020310705554
2,35,1,0,8,9,0.562294557401062,0.3845775375541508
2,36,1,1,6,8,0.515103635022456,0.3523016272071674
2,37,1,2,7,10,0.4465295708553723,0.30540086249169596
2,38,1,2,36,39,2.058944140662669,1.408200839142785
2,39,1,2,34,37,0.9635496120793529,0.6590132026841397
2,40,1,2,14,17,0.8188726426966173,0.5600623736325894
2,41,1,0,9,10,1.4848359736535524,1.0155434636586873
2,42,1,1,3,5,0.19710699120222908,0.13480998582241965
2,43,1,2,30,33,0.8546583427195497,0.5845377597328583
2,44,1,1,8,10,0.8615796316607545,0.5892715282224771
2,45,1,1,11,13,1.5873338923296165,1.0856462179002702
2,46,1,1,12,14,0.7053928771338077,0.48244865991627506
2,47,1,1,16,18,2.766243336148752,1.8919533125284644
2,48,1,3,25,29,1.055273919706718,0.7217474189359098
2,49,1,2,33,36,2.5592593994101867,1.75038805699389
2,50,1,1,14,16,2.234804345994529,1.5284792302993524
2,51,1,1,7,9,1.0230163732805062,0.6996850894880312
2,52,1,2,35,38,2.215152364962736,1.5150383915542651
2,53,1,2,6,9,0.3180793663999057,0.21754821893040285
2,54,1,3,12,16,0.39277672978196987,0.2686369724905268
2,55,1,2,12,15,0.33181818181818185,0.22694478827813533
2,56,1,1,10,12,1.5371629134497122,1.0513321181809077
2,57,1,0,10,11,3.9396878048901285,2.6945226746274415
2,58,1,2,5,8,0.11277173598360139,0.07712946170195019
2,59,1,2,2,5,1.1886045833867087,0.812938019384739
2,60,1,2,11,14,0.17975430709409262,0.12294173556741629
2,61,1,1,13,15,1.4513052684561305,0.9926103659298379
2,62,1,2,12,15,0.9409705733096603,0.6435704227103785
2,63,1,2,3,6,1.3809544334960115,0.9444943909168635
2,64,1,1,23,25,1.971218488094641,1.3482014758181997
2,65,1,1,22,24,1.569170332445322,1.0732233746741051
2,66,1,1,21,23,1.5934060753362176,1.0897992461619173
2,67,1,1,20,22,1.1923856118159195,0.8155240280586428
2,68,1,1,19,21,1.0973246977749744,0.7505077625474013
2,69,1,1,18,20,0.8510057450224554,0.5820395903845419
2,70,1,2,10,13,0.6378306715431804,0.43623994899105417
2,71,1,2,9,12,0.44268519847514615,0.30277153015338903
2,72,1,2,8,11,0.15429330384404602,0.10552785559173461
2,73,1,1,17,19,2.768890689404376,1.893763951779162
2,74,1,1,15,17,2.6420199566866662,1.8069915771686307
2,75,1,0,1,2,0.020202308534863316,0.01381723149723708
2,76,1,0,0,1,0.02715518986740276,0.018572607388003603
2,77,1,1,3,5,2.0209079071769014,1.3821862159897498
2,78,1,1,9,11,5.396914122474728,3.6911827018310586
3,0,2,0,0,2,0.0009011280152243382,0.0006163203761349101
3,1,1,0,2,3,1.7353807327922761,1.1869018473535569
3,2,1,1,1,3,0.15281722975462075,0.1045183047591916
3,4,0,0,1,1,0.22727272727272727,0.15544163580694204
3,5,1,0,5,6,0.6224600393300617,0.42572730964684036
3,6,1,0,4,5,1.2500042165555465,0.8549318808226642
3,7,1,1,3,5,0.6527317745546902,0.4464314570317762
3,8,1,0,1,2,5.718181818181818,3.9109115569026613
3,9,1,0,2,3,9.72223214285208,6.6494545391109385
3,10,1,0,3,4,9.080255306288139,6.210378848758012
3,11,1,0,5,6,0.12334887775192595,0.0843636258639235
3,12,1,0,6,7,0.0016047732464296277,0.001097573745506648
3,13,1,0,4,5,0.004851304612982641,0.0033180167892950564
3,14,1,2,23,26,0.26407179781092294,0.1806101097777236
3,15,1,1,5,7,0.4904160829777998,0.3354167439220498
3,16,1,2,1,4,0.37006005518624197,0.25310005742980946
3,17,0,1,1,2,0.5029664070408383,0.34400045269201984
3,18,1,0,3,4,0.42235366941514224,0.28886591915699816
3,19,1,1,4,6,0.0045535923786306455,0.003114398531782435
3,20,1,1,23,25,0.010263787025407159,0.007019847317134767
3,21,1,1,24,26,0.669123757132934,0.4576426420105332
3,22,1,2,27,30,1.2286403819027099,0.840320231438262
3,23,1,2,28,31,2.1105848505536544,1.4435201513894054
3,24,1,2,25,28,1.2315252629984677,0.8422933262394476
3,25,1,2,26,29,1.0018070897768063,0.6851791443107547
3,26,1,3,23,27,0.9805830968747846,0.6706631387405559
3,27,1,2,31,34,1.268125958326126,0.8673261228344196
3,28,1,2,30,33,1.1503872574111247,0.7867995392551663
3,29,1,1,6,8,0.42901794354793693,0.29342390411673513
3,30,1,2,24,27,3.2923780132065112,2.2517995458975713
3,31,1,2,12,15,0.2393480866608419,0.16370049571842116
3,32,1,1,7,9,0.9597777624522296,0.6564334717894852
3,33,1,1,8,10,0.9525754563287886,0.651507503509681
3,34,1,3,10,14,0.27500789130091846,0.1880897765279828
3,35,1,0,7,8,0.5629286438338613,0.385011216656523
3,36,1,1,5,7,0.4552398902712136,0.31135822620465303
3,37,1,2,6,9,0.3770538621793858,0.2578834241477516
3,38,1,2,35,38,1.9965712864399403,1.3655413497853377
3,39,1,2,33,36,0.9056620591766549,0.619421404653492
3,40,1,2,13,16,0.737585610521184,0.5044666609271294
3,41,1,0,8,9,1.4824147993257302,1.0138875179470892
3,42,0,0,2,2,0.13097188674138463,0.0895773310071304
3,43,1,2,29,32,0.8192330414983432,0.5603088659414351
3,44,1,1,7,9,0.7992265499980388,0.5466255621729491
3,45,1,1,10,12,1.5078406889898022,1.0312773822245018
3,46,1,1,11,13,0.6761229342525088,0.46242968158991765
3,47,1,1,15,17,2.684867158689226,1.836296629512355
3,48,1,3,24,28,1.0065841700628673,0.6884463958765589
3,49,1,2,32,35,2.4814162605583263,1.6971477717001777
3,50,1,1,13,15,2.1516235167972337,1.4715882680032484
3,51,1,1,6,8,0.9750645455843194,0.6668887631251085
3,52,1,2,34,37,2.1290692802255164,1.456162451324077
3,53,1,2,5,8,0.24756634966082056,0.16932132079293788
3,54,1,3,11,15,0.3242565842277681,0.22177308504355728
3,55,1,2,11,14,0.34873591087983774,0.23851555398785806
3,56,1,1,9,11,1.4528142960124757,0.9936424550619166
3,57,1,0,9,10,3.8744630595735456,2.649912653756198
3,58,1,2,4,7,0.15613341479051945,0.10678638695631341
3,59,1,2,3,6,1.140355621616311,0.7799384701929992
3,60,1,2,10,13,0.14697383164884315,0.10052175237416525
3,61,1,1,12,14,1.3950049427401898,0.9541041411365402
3,62,1,2,11,14,0.9010572302753055,0.6162719632505301
3,63,1,2,4,7,1.3285719619387906,0.9086677558244173
3,64,1,1,22,24,1.8735658311861543,1.281412605402903
3,65,1,1,21,23,1.4838107994368388,1.0148423027268618
3,66,1,1,20,22,1.496003724745206,1.0231815710497614
3,67,1,1,19,21,1.1073874278152172,0.7573900983072128
3,68,1,1,18,20,1.0007097489254253,0.6844286255000583
3,69,1,1,17,19,0.7553915740632908,0.5166449285675865
3,70,1,2,9,12,0.5442447681565863,0.3722325069831706
3,71,1,2,8,11,0.3545174146042096,0.24246977413175536
3,72,1,2,7,10,0.17807321371965085,0.12179196318951956
3,73,1,1,16,18,2.688157509896022,1.8385470428377961
3,74,1,1,14,16,2.544068113351114,1.7399980802317432
3,75,1,0,0,1,0.012922857168060917,0.008838500253012563
3,76,1,0,1,2,0.09813816043294914,0.0671209272482396
3,77,1,1,4,6,1.9445382231849981,1.329953690124403
3,78,1,1,8,10,5.120397803293743,3.5020612463155087
4,0,2,0,0,2,0.0008630459702540567,0.0005902744205286721
4,1,1,0,2,3,1.6549714059883434,1.1319064352663886
4,2,1,1,1,3,0.3437675360285792,0.2351174678054586
4,3,0,0,1,1,0.20833333333333334,0.1424881661563635
4,5,1,0,5,6,0.5714406186234586,0.39083292391158986
4,6,1,0,4,5,1.1607188266190351,0.7938657457349395
4,7,1,1,3,5,0.6193986834901044,0.4236335161448199
4,8,1,0,1,2,5.468181818181818,3.739925757515025
4,9,1,0,2,3,9.34028810408351,6.388226511950194
4,10,1,0,3,4,8.740749459436259,5.978176134275032
4,11,1,0,5,6,0.11971562277674097,0.08187868583867906
4,12,1,0,6,7,0.001547471553042934,0.001058382642106692
4,13,1,0,4,5,0.004486361363011153,0.0030684163359850684
4,14,1,2,23,26,0.24788522352482026,0.16953941240309714
4,15,1,1,5,7,0.47838361041563937,0.32718721616344654
4,16,1,2,1,4,0.8265137627408269,0.5652884657084934
4,17,0,1,0,1,0.05454545454545454,0.037305992593666085
4,18,1,0,3,4,0.4007850811550152,0.27411422993571577
4,19,1,1,4,6,0.003815465363136104,0.002609561580606658
4,20,1,1,23,25,0.00962397637946464,0.006582253178121962
4,21,1,1,24,26,0.6446864473786257,0.44092891023763836
4,22,1,2,27,30,1.1733409160230261,0.8024985379216738
4,23,1,2,28,31,2.0276243070594986,1.3867798520014811
4,24,1,2,25,28,1.1640947547685114,0.7961746888281932
4,25,1,2,26,29,0.9522723806430163,0.6513002169560541
4,26,1,3,23,27,0.9200275089821776,0.6292465563277332
4,27,1,2,31,34,1.211297549519614,0.8284587192035844
4,28,1,2,30,33,1.0936617027851385,0.7480024820414413
4,29,1,1,6,8,0.3761827918525478,0.2572876615231226
4,30,1,2,24,27,3.1611191310025157,2.16202592629606
4,31,1,2,12,15,0.25869925528988763,0.1769355958669105
4,32,1,1,7,9,0.9008721261260297,0.6161453625267945
4,33,1,1,8,10,0.8742355261038303,0.5979274411357365
4,34,1,3,10,14,0.2248649285929469,0.15379483827883508
4,35,1,0,7,8,0.5641021010093729,0.3858137947093309
4,36,1,1,5,7,0.38044466119299325,0.2602025380673695
4,37,1,2,6,9,0.2907031555759425,0.19882444576264363
4,38,1,2,35,38,1.9184133806168695,1.3120857817628522
4,39,1,2,33,36,0.8333668974722173,0.5699756205899253
4,40,1,2,13,16,0.6439814660669781,0.4404467430651367
4,41,1,0,8,9,1.4804005388122163,1.0125098781707769
4,42,0,0,1,1,0.09104258187616189,0.06226795456163944
4,43,1,2,29,32,0.7748548809326752,0.5299567249027406
4,44,1,1,7,9,0.7211973712727858,0.4932580361733566
4,45,1,1,10,12,1.4083732279223198,0.9632472888497737
4,46,1,1,11,13,0.6395015420014422,0.4373827294749704
4,47,1,1,15,17,2.5830757869760625,1.7666771132597983
4,48,1,3,24,28,0.9455953071713099,0.6467334779755354
4,49,1,2,32,35,2.3839078383261074,1.630457549610565
4,50,1,1,13,15,2.047558717095577,1.4004138561428405
4,51,1,1,6,8,0.9220909586971943,0.6306578387238064
4,52,1,2,34,37,2.0211966752396955,1.3823837169419677
4,53,1,2,5,8,0.1628738939050212,0.1113964917949084
4,54,1,3,11,15,0.24966259370976657,0.17075503265062028
4,55,1,2,11,14,0.40279242239296165,0.2754871373205719
4,56,1,1,9,11,1.3472660240817218,0.9214534324616623
4,57,1,0,9,10,3.792540573283297,2.593882326531555
4,58,1,2,4,7,0.2663912396828713,0.18219647626815666
4,59,1,2,3,6,1.080048868988294,0.7386920769667034
4,60,1,2,10,13,0.11487334850876553,0.0785668452924232
4,61,1,1,12,14,1.3245674619322834,0.9059289052853756
4,62,1,2,11,14,0.8511193407692043,0.5821172834228014
4,63,1,2,4,7,1.263095799111226,0.8638857796567926
4,64,1,1,22,24,1.7513234108562774,1.197805733566169
4,65,1,1,21,23,1.3769545101943386,0.9417586705839602
4,66,1,1,20,22,1.3740756691373683,0.9397897068262162
4,67,1,1,19,21,1.0010103843371363,0.6846342430448409
4,68,1,1,18,20,0.8799117335284378,0.6018096445916828
4,69,1,1,17,19,0.6362586077562152,0.4351647466578438
4,70,1,2,9,12,0.42909426813216406,0.2934761057969232
4,71,1,2,8,11,0.2530308939454159,0.17305875868410056
4,72,1,2,7,10,0.2537992563030869,0.17358427489188352
4,73,1,1,16,18,2.5871521014217547,1.7694650807960066
4,74,1,1,14,16,2.421497460698311,1.6561667161305278
4,75,1,0,0,1,0.00897658762545078,0.00613947604364346
4,76,1,0,1,2,0.2184536987439168,0.1494099212356579
4,77,1,1,4,6,1.8490569548554698,1.2646499261569237
4,78,1,1,8,10,4.796833506367756,3.280761646462756
5,0,1,0,0,1,0.0006052228542243757,0.00041393805414888685
5,1,0,0,3,3,0.7543987147025402,0.5159658691616766
5,2,0,1,4,5,2.4826995913324814,1.6980254970533686
5,3,0,1,5,6,2.5417118272644186,1.7383865143912645
5,4,0,1,6,7,2.5455082102317705,1.7409830246970819
5,6,0,0,1,1,0.16074707785617243,0.10994187042585696
5,7,0,1,2,3,0.24606060606060606,0.16829147770031588
5,8,0,0,6,6,2.6682437657358875,1.8249271729817096
5,9,0,0,7,7,5.062519051937936,3.462475468042985
5,10,0,0,8,8,4.938287037012924,3.3775078265170255
5,11,0,0,10,10,0.0820647677586378,0.0561276396670856
5,12,0,0,11,11,0.0011839450854645329,0.0008097511874768657
5,13,0,0,9,9,0.0008757677865790431,0.0005989754202646338
5,14,0,2,28,30,0.07306714308058844,0.049973775474420834
5,15,0,1,10,11,0.3588412657355359,0.24542704270024718
5,16,0,2,4,6,5.958356643311047,4.0751774947726895
5,17,0,2,6,8,5.600029515860823,3.8301020934552805
5,18,0,0,2,2,0.15923307159017897,0.10890637613918183
5,19,0,1,9,10,0.018341605612006515,0.012544616390486754
5,20,0,1,28,29,0.002799940984716973,0.0019150005900401476
5,21,0,1,29,30,0.3723465861661576,0.25466391473951133
5,22,0,2,32,34,0.5583255096784292,0.38186293436350255
5,23,0,2,33,35,1.1034059050812752,0.7546669629174404
5,24,0,2,30,32,0.42106548645134295,0.2879848751817071
5,25,0,2,31,33,0.4032598115797937,0.27580680497551435
5,26,0,3,28,31,0.26241283091182965,0.17947547065212724
5,27,0,2,36,38,0.5822106010953233,0.39819898016096017
5,28,0,2,35,37,0.46927516877390574,0.3209575594622967
5,29,0,1,11,12,0.22805126130346445,0.1559741088613263
5,30,0,2,29,31,1.695711600887054,1.1597704144342451
5,31,0,2,17,19,0.8593941214837193,0.5877767634037164
5,32,0,1,12,13,1.0548930199919149,0.7214869051670211
5,33,0,1,13,14,0.07619791630339764,0.05211504652323458
5,34,0,3,15,18,1.2520157358347288,0.8563076457504027
5,35,0,0,12,12,0.6438269328176326,0.4403410511004516
5,36,0,1,10,11,0.4792121678030752,0.3277539023523635
5,37,0,2,11,13,0.7176331921972283,0.49082034013977704
5,38,0,2,40,42,1.0535058474526804,0.7205381579449828
5,39,0,2,38,40,0.2947489253794587,0.20159152249861392
5,40,0,2,18,20,1.1778923034045035,0.8056114283606527
5,41,0,0,13,13,1.6407849267208845,1.1222036892742182
5,42,0,1,7,8,1.1523355540296987,0.7881320634742507
5,43,0,2,34,36,0.2912086075587787,0.1991701462079929
5,44,0,1,12,13,0.17590141356618952,0.12030657524812047
5,45,0,1,15,16,0.3042237928763444,0.20807179367080164
5,46,0,1,16,17,0.23072157342659672,0.15780045067327936
5,47,0,1,20,21,1.444079963511401,0.9876686677626616
5,48,0,3,29,32,0.29392754811122046,0.20102974710337976
5,49,0,2,37,39,1.3007185023858852,0.8896175716349584
5,50,0,1,18,19,0.8845021407325786,0.6049492223729418
5,51,0,1,11,12,1.2380294882953673,0.8467418468865984
5,52,0,2,39,41,0.8549268974596599,0.5847214359205266
5,53,0,2,10,12,0.8998910979975113,0.6154743950116887
5,54,0,3,16,19,1.0336971305974136,0.7069901207996182
5,55,0,2,16,18,1.6608427861572503,1.1359221257931456
5,56,0,1,14,15,0.18733967504550084,0.12812969637869986
5,57,0,0,14,14,3.0071548014693223,2.0567230704464023
5,58,0,2,9,11,1.7544586059522749,1.1999500289250704
5,59,0,2,2,4,0.4046067489156384,0.2767280336038922
5,60,0,2,15,17,0.5631727895828834,0.3851781984807774
5,61,0,1,17,18,0.5376443738339673,0.36771821218506423
5,62,0,2,16,18,0.2938276888650926,0.20096144905127808
5,63,0,2,3,5,0.5297739431483982,0.36233528465587606
5,64,0,1,27,28,0.40834184749210467,0.27928262886744704
5,65,0,1,26,27,0.22664667078716655,0.15501344873236036
5,66,0,1,25,26,0.17669211988538663,0.12084737345639557
5,67,0,1,24,25,0.26292573827538496,0.17982627015440447
5,68,0,1,23,24,0.5407224976966523,0.3698234740621655
5,69,0,1,22,23,0.7813201499117779,0.5343786016413324
5,70,0,2,14,16,0.9956508181376457,0.6809686042008775
5,71,0,2,13,15,1.1983135803545935,0.8195784218159625
5,72,0,2,12,14,1.4924360794985119,1.0207415043520116
5,73,0,1,21,22,1.4574192070320577,0.996791952629085
5,74,0,1,19,20,1.053084216947863,0.7202497866293331
5,75,0,0,5,5,0.12562092149728105,0.08591757472809639
5,76,0,0,4,4,1.5919701696470063,1.088817168233457
5,77,0,1,3,4,0.7799487620180295,0.5334406502202
5,78,0,1,13,14,5.2068331172711035,3.56117809133847
6,0,1,0,0,1,0.0006047273064730442,0.00041359912763530224
6,1,0,0,2,2,0.6096508757880754,0.41696656937598636
6,2,0,1,3,4,2.8264080841554025,1.9331025826599557
6,3,0,1,4,5,2.916676505296275,1.994841055252883
6,4,0,1,5,6,2.9545570132120895,2.0207491709616643
6,5,0,0,1,1,0.09185547306066996,0.06282392595763255
6,7,0,1,1,2,0.18606455429627888,0.12725758621621397
6,8,0,0,5,5,2.218200447015665,1.5171231065399418
6,9,0,0,6,6,4.375,2.992251489283634
6,10,0,0,7,7,4.327160493827161,2.959531984462543
6,11,0,0,9,9,0.07667753539804649,0.052443078740435
6,12,0,0,10,10,0.0011858471230646323,0.000811052073154939
6,13,0,0,8,8,0.0009159718866713741,0.0006264727410364249
6,14,0,2,27,29,0.0503002605674357,0.03440252105011756
6,15,0,1,9,10,0.34263143907238575,0.2343404420205122
6,16,0,2,3,5,6.783415232920819,4.639470704716939
6,17,0,2,5,7,6.5001017156695005,4.445700351818781
6,18,0,0,1,1,0.12040237550041855,0.08234838569243766
6,19,0,1,8,9,0.02131522251484179,0.01457840144330226
6,20,0,1,27,28,0.0019916936326043514,0.0013622053116244801
6,21,0,1,28,29,0.3287572868168918,0.22485130996358657
6,22,0,2,31,33,0.460607168171626,0.31502913941400346
6,23,0,2,32,34,0.9556871479210971,0.6536357238071158
6,24,0,2,29,31,0.30814033307595473,0.21075048469825847
6,25,0,2,30,32,0.3171441302284725,0.21690857051284787
6,26,0,3,27,30,0.17467430008765203,0.11946729933185216
6,27,0,2,35,37,0.48328506404088256,0.3305395320285411
6,28,0,2,34,36,0.3732380482011447,0.2552736241342153
6,29,0,1,10,11,0.3218353032688902,0.2201170664023741
6,30,0,2,28,30,1.4607511318455229,0.9990707999400045
6,31,0,2,16,18,0.9701458359088054,0.6635246451018146
6,32,0,1,11,12,1.1887540469512279,0.8130402439729733
6,33,0,1,12,13,0.16675779821437473,0.11405286172722798
6,34,0,3,14,17,1.4546814394491248,0.9949194751142637
6,35,0,0,11,11,0.6650560530578108,0.45486056347870396
6,36,0,1,9,10,0.6140671363050362,0.4199870407151727
6,37,0,2,10,12,0.8761524297317619,0.5992384943324203
6,38,0,2,39,41,0.9168805825418909,0.6270942373957071
6,39,0,2,37,39,0.3516824641001532,0.24053082901911346
6,40,0,2,17,19,1.396580257719699,0.9551815671007752
6,41,0,0,12,12,1.6906727432728306,1.1563241220455713
6,42,0,1,6,7,1.3348268384380577,0.9129457360576096
6,43,0,2,33,35,0.22053678896565687,0.15083463662270108
6,44,0,1,11,12,0.3088935347099161,0.21126563183219024
6,45,0,1,14,15,0.14174494668129384,0.0969454920698356
6,46,0,1,15,16,0.16552945357246848,0.11321274376514856
6,47,0,1,19,20,1.2609493016332727,0.8624176973081868
6,48,0,3,28,31,0.2128646486759914,0.14558732846093092
6,49,0,2,36,38,1.128431557788174,0.7717830878505861
6,50,0,1,17,18,0.6980033918814816,0.4773946717445466
6,51,0,1,10,11,1.3929525621060388,0.9527004293630281
6,52,0,2,38,40,0.6860029154456998,0.46918702751892805
6,53,0,2,9,11,1.06561933116157,0.7288230927263173
6,54,0,3,15,18,1.2174244781354076,0.8326491903522341
6,55,0,2,15,17,1.8807377772504228,1.2863178091267586
6,56,0,1,13,14,0.09912710745276825,0.06779731083518277
6,57,0,0,13,13,2.9052958541257037,1.9870573363010753
6,58,0,2,8,10,1.996262968664578,1.3653304779401947
6,59,0,2,1,3,0.2960546621112952,0.20248457225414537
6,60,0,2,14,16,0.6584105264775114,0.45031540077996685
6,61,0,1,16,17,0.41163630117428224,0.28153584805301773
6,62,0,2,15,17,0.2051002576850632,0.14027692605956285
6,63,0,2,2,4,0.4119064822424851,0.281720636556722
6,64,0,1,26,27,0.22637274337103072,0.15482609793947166
6,65,0,1,25,26,0.15285620939939967,0.10454496462208107
6,66,0,1,24,25,0.2888448056438769,0.1975534399679388
6,67,0,1,23,24,0.43319326239900197,0.2962795850425256
6,68,0,1,22,23,0.7520466600486343,0.5143571973808706
6,69,0,1,21,22,0.9970685069049843,0.6819382227895425
6,70,0,2,13,15,1.2131301125442953,0.8297120882183977
6,71,0,2,12,14,1.4167145365686766,0.968952270157119
6,72,0,2,11,13,1.6971815893481232,1.1607758030426714
6,73,0,1,20,21,1.2758279971403659,0.8725938798886893
6,74,0,1,18,19,0.8341437518727005,0.5705069448726232
6,75,0,0,4,4,0.14541587098593528,0.09945619577671809
6,76,0,0,3,3,1.8128092298668128,1.2398585412242487
6,77,0,1,2,3,0.608057891251034,0.4158770584380738
6,78,0,1,12,13,5.862359814213986,4.009521116525332
7,0,2,0,0,2,0.0006961067226298661,0.000476097457711901
7,1,1,0,1,2,0.16087851094543054,0.11003176319318811
7,2,1,1,2,4,3.8923998288291424,2.6621803850745973
7,3,1,1,3,5,4.079573590966814,2.7901966064486015
7,4,1,1,4,6,4.223172841977984,2.888410337351045
7,5,1,0,2,3,0.37662337662337664,0.2575889964800754
7,6,1,0,1,2,0.4983871990078899,0.340868534507716
7,8,1,0,4,5,0.8229281522719056,0.5628361118192089
7,9,1,0,5,6,2.243098554799412,1.5341519979905163
7,10,1,0,6,7,2.432130099440944,1.6634388370705637
7,11,1,0,8,9,0.06305546035431334,0.043126353177750675
7,12,1,0,9,10,0.0013254280292676409,0.0009065174844604275
7,13,1,0,7,8,0.0026099000200172882,0.0017850233649778552
7,14,1,2,26,29,0.07107115438249734,0.048608632581973656
7,15,1,1,8,10,0.30395250563084564,0.2078862486046606
7,16,1,2,2,5,9.341681534332505,6.389179539090254
7,17,1,2,4,7,9.290926881320807,6.354466239418865
7,18,1,0,0,1,0.002352941176470588,0.0016092781118836352
7,19,1,1,7,9,0.030652394343307562,0.02096449659974201
7,20,1,1,26,28,0.0031063263360816603,0.002124550766935159
7,21,1,1,27,29,0.1965472449954619,0.13442715121194654
7,22,1,2,30,33,0.18035324541952036,0.12335137536084491
7,23,1,2,31,34,0.5111003811705588,0.3495636289670943
7,24,1,2,28,31,0.18026382467598992,0.12329021665158738
7,25,1,2,29,32,0.1097847012762731,0.0750864996330256
7,26,1,3,26,30,0.260495728739183,0.1781642816621362
7,27,1,2,34,37,0.2113993144238857,0.14458512306706542
7,28,1,2,33,36,0.16242653253770528,0.11109052203088575
7,29,1,1,9,11,0.6171395022647511,0.42208836451370557
7,30,1,2,27,30,0.7459359299702711,0.5101778051117065
7,31,1,2,15,18,1.3203806277533237,0.9030653485294039
7,32,1,1,10,12,1.6811586444852145,1.1498170188989572
7,33,1,1,11,13,0.5934214182112377,0.40586654226637303
7,34,1,3,13,17,2.089459742107727,1.4290717771702957
7,35,1,0,10,11,0.745989714438074,0.5102145906325943
7,36,1,1,8,10,1.0355378862994604,0.7082490931403855
7,37,1,2,9,12,1.3702132648821879,0.9371480417096952
7,38,1,2,38,41,0.5196880988076191,0.3554371400274466
7,39,1,2,36,39,0.6962268791737004,0.4761796379626975
7,40,1,2,16,19,2.1078806577298064,1.4416706371026695
7,41,1,0,11,12,1.8891534003702066,1.2920736173126839
7,42,1,1,5,7,1.9025333266423774,1.3012247268702628
7,43,1,2,32,35,0.14625095819907194,0.10002734799550436
7,44,1,1,10,12,0.7416004215875424,0.5072125636454159
7,45,1,1,13,15,0.4551285678053116,0.31128208796136475
7,46,1,1,14,16,0.05539755309477928,0.03788877960011942
7,47,1,1,18,20,0.6958455002509384,0.47591879644278523
7,48,1,3,27,31,0.2813986172734774,0.19246067008432416
7,49,1,2,35,38,0.6178106918955096,0.4225474200959293
7,50,1,1,16,18,0.14880386648041943,0.10177339224850242
7,51,1,1,9,11,1.942723692968772,1.3287126545262649
7,52,1,2,37,40,0.41891765300593387,0.2865158791072481
7,53,1,2,8,11,1.581549257369686,1.081689856169113
7,54,1,3,14,18,1.793896563844267,1.226923351950583
7,55,1,2,14,17,2.5707368625607963,1.7582379898408864
7,56,1,1,12,14,0.6288490943238709,0.4300970603486325
7,57,1,0,12,13,2.67504990607652,1.82958218636926
7,58,1,2,7,10,2.747942547599168,1.8794366126901652
7,59,0,1,0,1,0.04058499018272314,0.027757827958129134
7,60,1,2,13,16,0.9569657008256404,0.6545101813688866
7,61,1,1,15,17,0.06914762338544513,0.047293046641262174
7,62,1,2,14,17,0.09214164446453134,0.06301965094263703
7,63,0,1,1,2,0.0465657314657332,0.03184831527495359
7,64,1,1,25,27,0.5661112114231439,0.3871879121099576
7,65,1,1,24,26,0.6456607054653638,0.44159524742872147
7,66,1,1,23,25,0.9342044542670779,0.6389427816173872
7,67,1,1,22,24,1.0176249839258842,0.6959976854135911
7,68,1,1,21,23,1.428337732001141,0.9769018756069536
7,69,1,1,20,22,1.6767092872054536,1.146773911253993
7,70,1,2,12,15,1.8943858592697056,1.295652321983459
7,71,1,2,11,14,2.0989384198765033,1.435554654352024
7,72,1,2,10,13,2.3349743113623807,1.5969897967115683
7,73,1,1,19,21,0.7165463812477451,0.4900770231838546
7,74,1,1,17,19,0.20225234446561238,0.13832911518590518
7,75,1,0,3,4,0.20696865516185434,0.14155480380413477
7,76,1,0,2,3,2.498056084161712,1.7085284658621545
7,77,0,0,1,1,0.07906456622733124,0.05407567223846776
7,78,1,1,11,13,8.336101039811348,5.701419600272997
8,0,1,0,0,1,0.0007922604894034031,0.0005418611724155232
8,1,0,0,3,3,0.10381146477237856,0.07100114515882634
8,2,0,1,2,3,4.520834666751809,3.0919941175755845
8,3,0,1,1,2,4.765151515151516,3.259092964085551
8,4,0,1,2,3,4.971074380165289,3.399932506831841
8,5,0,0,6,6,0.5445395440277321,0.37243411693504286
8,6,0,0,5,5,0.7922144453627374,0.5418296809071221
8,7,0,1,4,5,0.10972375363625408,0.07504481490922785
8,9,0,0,1,1,0.9862089153375962,0.6745108790088503
8,10,0,0,2,2,1.3148727744716564,0.8992982897443013
8,11,0,0,4,4,0.05740188240622322,0.03925962699833268
8,12,0,0,5,5,0.0014701096673743808,0.001005471506654002
8,13,0,0,3,3,0.0037795082348359914,0.0025849689473023433
8,14,0,2,22,24,0.11933892929531198,0.08162104889449406
8,15,0,1,4,5,0.28851300343425296,0.1973265061037343
8,16,0,2,2,4,10.850115206761632,7.4208624883043415
8,17,0,2,2,4,10.936499659095153,7.479944546851984
8,18,0,0,4,4,0.07098472524960574,0.04854951996446226
8,19,0,1,3,4,0.03616382589539434,0.024734002718557198
8,20,0,1,22,23,0.005009409674757499,0.003426151670794279
8,21,0,1,23,24,0.12242647340467716,0.08373275368523164
8,22,0,2,26,28,0.12455409704012417,0.08518792739764339
8,23,0,2,27,29,0.2764144690092868,0.1890517957834476
8,24,0,2,24,26,0.35841825962696044,0.2451377305497647
8,25,0,2,25,27,0.17701092425974274,0.12106541753958576
8,26,0,3,22,25,0.44432498394533776,0.3038930502711688
8,27,0,2,30,32,0.16569050067486937,0.11332289083532088
8,28,0,2,29,31,0.23221691622393828,0.15882318020752736
8,29,0,1,5,6,0.7914978936599008,0.5413396002442736
8,30,0,2,23,25,0.35533363243443333,0.24302802076445634
8,31,0,2,11,13,1.5275754749728667,1.044774854852735
8,32,0,1,6,7,1.992047024261243,1.3624470114442822
8,33,0,1,7,8,0.8500300114749851,0.5813722440621276
8,34,0,3,9,12,2.4638964244216477,1.685165198952296
8,35,0,0,6,6,0.7989126285892728,0.5464108577608582
8,36,0,1,4,5,1.2840723938864338,0.8782325789610702
8,37,0,2,5,7,1.6614077628392365,1.136308537751565
8,38,0,2,34,36,0.33415599040197086,0.22854371655619313
8,39,0,2,32,34,0.9294645345507564,0.6357009457704732
8,40,0,2,12,14,2.532945881410138,1.7323911053541332
8,41,0,0,7,7,2.0219682152278335,1.3829114064684929
8,42,0,1,3,4,2.237026306081694,1.5299989247861976
8,43,0,2,28,30,0.25141372670592793,0.1719527081513512
8,44,0,1,6,7,0.9980714107809799,0.6826241520733267
8,45,0,1,9,10,0.7782225788761412,0.532260039002579
8,46,0,1,10,11,0.16656797077736432,0.11392303054297626
8,47,0,1,14,15,0.3651577632255622,0.24974716819089576
8,48,0,3,23,26,0.4573375529814896,0.31279290834610174
8,49,0,2,31,33,0.36357160398536326,0.24866232536832977
8,50,0,1,12,13,0.2507592923130847,0.1715051122001229
8,51,0,1,5,6,2.2848468599910827,1.5627054673356233
8,52,0,2,33,35,0.5884827949906437,0.4024888045093826
8,53,0,2,4,6,1.88557073650041,1.2896232787298263
8,54,0,3,10,13,2.134109196251292,1.459609467606132
8,55,0,2,10,12,2.977891157144877,2.036708399975159
8,56,0,1,8,9,0.9734360085397978,0.6657749362915489
8,57,0,0,8,8,2.5881653733871026,1.7701581012639749
8,58,0,2,3,5,3.1908056017739765,2.1823297860394844
8,59,0,2,4,6,0.23905772064104458,0.16350190185438093
8,60,0,2,9,11,1.1331170497199365,0.7749876981844931
8,61,0,1,11,12,0.22805382480578354,0.15597586215129938
8,62,0,2,10,12,0.2475132520035147,0.16928500501141766
8,63,0,2,5,7,0.1690518108132209,0.11562183603930411
8,64,0,1,21,22,0.9567251762229722,0.6543456762030482
8,65,0,1,20,21,0.9913509176097548,0.6780277164846825
8,66,0,1,19,20,1.3319909221332584,0.9110061303921198
8,67,0,1,18,19,1.3672446974642618,0.9351177102177346
8,68,0,1,17,18,1.8291058985400437,1.25100453690604
8,69,0,1,16,17,2.0781825410170938,1.4213588121969478
8,70,0,2,8,10,2.2962892318452104,1.5705313997290977
8,71,0,2,7,9,2.5011447076355187,1.7106409088768595
8,72,0,2,6,8,2.7107569284242365,1.8540037614087659
8,73,0,1,15,16,0.3907190630692016,0.2672296453395028
8,74,0,1,13,14,0.30252741959133533,0.20691157070201324
8,75,0,0,1,1,0.243235462817086,0.16635924019680445
8,76,0,0,2,2,2.9019307999443775,1.9847558303843682
8,77,0,1,5,6,0.2403432493491674,0.1643811304695575
8,78,0,1,7,8,9.91382031010748,6.780489962836445
9,0,1,0,0,1,0.0008870078218015784,0.0006066629658953156
9,1,0,0,4,4,0.31140694065044644,0.2129846587278991
9,2,0,1,3,4,5.013899709514332,3.429222599522981
9,3,0,1,2,3,5.303035714282953,3.6269752031514204
9,4,0,1,3,4,5.55785738424804,3.8012587509125115
9,5,0,0,7,7,0.6762548640807632,0.46251991409850635
9,6,0,0,6,6,1.0227272727272727,0.6994873611312391
9,7,0,1,5,6,0.1957613284188578,0.13388962891553596
9,8,0,0,1,1,0.6455185627664266,0.44149802989670195
9,10,0,0,1,1,0.4382716049382716,0.2997528828770907
9,11,0,0,3,3,0.055256281327723734,0.03779215773603584
9,12,0,0,4,4,0.001615610484677374,0.0011049858008864285
9,13,0,0,2,2,0.004720824269233181,0.0032287756457735563
9,14,0,2,21,23,0.16010245090122918,0.10950098220506581
9,15,0,1,3,4,0.2831191422747597,0.19363741145516683
9,16,0,2,3,5,12.033379501296475,8.230148053455892
9,17,0,2,3,5,12.227326799474895,8.362796988728329
9,18,0,0,5,5,0.1266763791577752,0.08663944781529397
9,19,0,1,2,3,0.04051169753997558,0.027707699953691437
9,20,0,1,21,22,0.006618550201959096,0.004526712388276709
9,21,0,1,22,23,0.07666232819172342,0.052432677875116594
9,22,0,2,25,27,0.22399886673084846,0.15320250115959486
9,23,0,2,26,28,0.1994597846516851,0.13641916289741662
9,24,0,2,23,25,0.5248540052918562,0.3589703266265228
9,25,0,2,24,26,0.2916736991680762,0.19948824245040972
9,26,0,3,21,24,0.597643520652385,0.40875422051035737
9,27,0,2,29,31,0.2557350007820596,0.17490821416047295
9,28,0,2,28,30,0.35637333391402903,0.24373911751890903
9,29,0,1,4,5,0.928725876682166,0.6351957457459336
9,30,0,2,22,24,0.2385756479224114,0.16317219149774703
9,31,0,2,10,12,1.691617642357127,1.1569703793466477
9,32,0,1,5,6,2.2467083062723305,1.5366208629552665
9,33,0,1,6,7,1.0525246615948274,0.7198670825519714
9,34,0,3,8,11,2.7590200869652577,1.8870130203852007
9,35,0,0,5,5,0.8448477364313375,0.5778278622981889
9,36,0,1,3,4,1.4795651878080267,1.011938545533894
9,37,0,2,4,6,1.8903624899453277,1.2929005659028172
9,38,0,2,33,35,0.29387013767099707,0.2009904816233206
9,39,0,2,31,33,1.1197718021493883,0.7658603068889889
9,40,0,2,11,13,2.8711029322234936,1.9636713199616818
9,41,0,0,6,6,2.1389142539982267,1.4628958541659853
9,42,0,1,4,5,2.4999327837328833,1.7098120217677029
9,43,0,2,27,29,0.35734102415494773,0.24440096267652148
9,44,0,1,5,6,1.2001211035662762,0.8208146650210075
9,45,0,1,8,9,1.0346122185457338,0.7076159889770324
9,46,0,1,9,10,0.26023066690918656,0.1779829944265798
9,47,0,1,13,14,0.13097188674138463,0.0895773310071304
9,48,0,3,22,25,0.609326856791654,0.41674495878750684
9,49,0,2,30,32,0.29679946676061897,0.2029939763275544
9,50,0,1,11,12,0.5111040306232925,0.34956612498546624
9,51,0,1,4,5,2.563659121310354,1.753397216858624
9,52,0,2,32,34,0.8198780397107854,0.5607500080812672
9,53,0,2,3,5,2.1245637835812974,1.4530809475426765
9,54,0,3,9,12,2.4023424872567545,1.643065802345914
9,55,0,2,9,11,3.299243120063942,2.2564948890331684
9,56,0,1,7,8,1.2458763342469776,0.8521086437974293
9,57,0,0,7,7,2.564360349092927,1.7538768168304482
9,58,0,2,2,4,3.5388032050113405,2.420340379537573
9,59,0,2,5,7,0.3947383650068089,0.269978619558631
9,60,0,2,8,10,1.2719801441533347,0.8699621670130346
9,61,0,1,10,11,0.40657401861177117,0.27807353433030957
9,62,0,2,9,11,0.37548866232842515,0.2568129163568799
9,63,0,2,6,8,0.3380973339975278,0.2312393716975837
9,64,0,1,20,21,1.270607005955887,0.8690230184835935
9,65,0,1,19,20,1.2667713389732738,0.866399640142766
9,66,0,1,18,19,1.6473834313728346,1.1267166916449252
9,67,0,1,17,18,1.6436135819253421,1.124138328759523
9,68,0,1,16,17,2.1452890311341712,1.4672558396240156
9,69,0,1,15,16,2.3945691586746918,1.6377492871398869
9,70,0,2,7,9,2.612802115196637,1.7870082332344153
9,71,0,2,6,8,2.817746842004264,1.9271787850083464
9,72,0,2,5,7,3.0063662197447303,2.056183725340155
9,73,0,1,14,15,0.16386091689754817,0.11207155945647322
9,74,0,1,12,13,0.6025504162685544,0.41211025838812704
9,75,0,0,2,2,0.27173459256592886,0.18585102612463594
9,76,0,0,3,3,3.2189241395830233,2.2015612686990496
9,77,0,1,6,7,0.48663476259738153,0.3328305355701035
9,78,0,1,6,7,11.210804676027703,7.667553597236988
10,0,1,0,0,1,0.0009373968553101652,0.0006411262025946599
10,1,0,0,5,5,0.4152072522776657,0.28397817576896245
10,2,0,1,4,5,5.260426980187909,3.597833249310876
10,3,0,1,3,4,5.571974847040448,3.8109142935560523
10,4,0,1,4,5,5.851245505903612,4.001919560960972
10,5,0,0,8,8,0.7421173469351519,0.5075661112205548
10,6,0,0,7,7,1.1379870129870129,0.7783184764333311
10,7,0,1,6,7,0.2387909552178381,0.16331944945783716
10,8,0,0,2,2,0.9682244975654924,0.6622105588117128
10,9,0,0,1,1,0.4930555555555556,0.337221993236727
10,11,0,0,2,2,0.054836432107354394,0.03750500471776733
10,12,0,0,3,3,0.0016935577656768327,0.0011582973134935694
10,13,0,0,1,1,0.005192532395900251,0.0035513972102368093
10,14,0,2,20,22,0.18067927581384863,0.12357436163124048
10,15,0,1,2,3,0.282057020054715,0.19291098018779995
10,16,0,2,4,6,12.625044004323751,8.634812965533522
10,17,0,2,4,6,12.872778633693121,8.804249380088407
10,18,0,0,6,6,0.15451776629229907,0.10568137515632284
10,19,0,1,1,2,0.042684078716859856,0.02919348528210829
10,20,0,1,20,21,0.007431506749514176,0.005082728488881182
10,21,0,1,21,22,0.06540749914098193,0.04473501410626769
10,22,0,2,24,26,0.2875791458468565,0.19668780055935353
10,23,0,2,25,27,0.23578503384543148,0.16126356998280783
10,24,0,2,22,24,0.6096515804417568,0.41696705131907835
10,25,0,2,23,25,0.35236555068060815,0.24099802143915366
10,26,0,3,20,23,0.6748616684958025,0.46156704745531496
10,27,0,2,28,30,0.31694409448320343,0.21677175742560414
10,28,0,2,27,29,0.4238162640749461,0.2898662508253448
10,29,0,1,3,4,0.9973045242937533,0.6820996452770947
10,30,0,2,21,23,0.3281961844907659,0.22446754784450293
10,31,0,2,9,11,1.7735849078416588,1.2130313329966127
10,32,0,1,4,5,2.374860876216358,1.6242699414171045
10,33,0,1,5,6,1.1537313024995668,0.7890866761457086
10,34,0,3,7,10,2.906477738986181,1.9878656784116864
10,35,0,0,4,4,0.8682948915978993,0.5938643845762711
10,36,0,1,2,3,1.577261895359481,1.0787575440867965
10,37,0,2,3,5,2.0047842101953246,1.371158523119834
10,38,0,2,32,34,0.3226366605299658,0.2206651492498945
10,39,0,2,30,32,1.2154301491780037,0.8312851826281397
10,40,0,2,10,12,3.0401983706931532,2.079322994839832
10,41,0,0,5,5,2.198882179736675,1.5039105090460136
10,42,0,1,5,6,2.6313250924415406,1.7996768975194501
10,43,0,2,26,28,0.4120960708904964,0.2818503044228622
10,44,0,1,4,5,1.3010962758621456,0.8898759472342617
10,45,0,1,7,8,1.162813478996317,0.7952983689796143
10,46,0,1,8,9,0.30722051436133696,0.21012138094541588
10,47,0,1,12,13,0.10285699316295419,0.07034834079430541
10,48,0,3,21,24,0.6863911951195196,0.4694525887605842
10,49,0,2,29,31,0.3364827830146829,0.23013511053576835
10,50,0,1,10,11,0.6436524538949251,0.44022171742814975
10,51,0,1,3,4,2.7037734048917637,1.849227427993797
10,52,0,2,31,33,0.9455178475311822,0.6466804999815853
10,53,0,2,2,4,2.2440035489739802,1.534770962600035
10,54,0,3,8,11,2.536366719387359,1.7347307642185759
10,55,0,2,8,10,3.459794158593067,2.3663026796948397
10,56,0,1,6,7,1.3820622829113576,0.9452520969883998
10,57,0,0,6,6,2.5621998360783644,1.7523991486509187
10,58,0,2,1,3,3.7127272673891105,2.5392945588912053
10,59,0,2,6,8,0.47258899132812077,0.3232240258561417
10,60,0,2,7,9,1.3413631477696637,0.9174162003620479
10,61,0,1,9,10,0.4966306593780931,0.3396671611766885
10,62,0,2,8,10,0.43962888180715365,0.30068118315875525
10,63,0,2,7,9,0.4226207243427503,0.28904856955810804
10,64,0,1,19,20,1.4277934544593411,0.9765296206846602
10,65,0,1,18,19,1.4045589876210367,0.9606385651418881
10,66,0,1,17,18,1.8050763920815096,1.2345697194232288
10,67,0,1,16,17,1.781748919299737,1.21861505309809
10,68,0,1,15,16,2.3032967201926025,1.5753241237162112
10,69,0,1,14,15,2.552667875233674,1.7458798288718747
10,70,0,2,6,8,2.770960601713781,1.8951796542227055
10,71,0,2,5,7,2.9759495810246888,2.03538047219523
10,72,0,2,4,6,3.15408203871498,2.157212954895465
10,73,0,1,13,14,0.12089105181953955,0.0826826125367045
10,74,0,1,11,12,0.7573315655164196,0.51797177252526
10,75,0,0,3,3,0.28597807784091706,0.19559276098787542
10,76,0,0,4,4,3.3773981110668245,2.3099484634842145
10,77,0,1,7,8,0.6097928094422981,0.4170636439332955
10,78,0,1,5,6,11.86410622559083,8.114374748009919
11,0,1,0,0,1,0.0007475997921439725,0.0005113157923270713
11,1,0,0,7,7,1.1718399423925203,0.8014719572173866
11,2,0,1,6,7,5.926387627594064,4.053312503940672
11,3,0,1,5,6,6.316957678810753,4.320440233637294
11,4,0,1,6,7,6.6882447105022225,4.574379473301409
11,5,0,0,10,10,1.029235306212229,0.7039384863627063
11,6,0,0,9,9,1.6829225301649164,1.1510234165108462
11,7,0,1,8,9,0.5166726206001917,0.35337472422011457
11,8,0,0,4,4,3.527606591509718,2.4126825318975356
11,9,0,0,3,3,5.18795085799184,3.5482636985500324
11,10,0,0,2,2,4.576472605502663,3.130047307309965
11,12,0,0,1,1,0.0012523981072894862,0.0008565691661058214
11,13,0,0,1,1,0.006735204630265363,0.0046064973909809275
11,14,0,2,20,22,0.25843377737875023,0.1767540240554881
11,15,0,1,0,1,0.08279613531514657,0.056627853532268936
11,16,0,2,6,8,14.248650033521695,9.745267264705507
11,17,0,2,6,8,14.739122617618394,10.080722652183482
11,18,0,0,8,8,0.33226888867163734,0.2272530461646457
11,19,0,1,1,2,0.047252191751987783,0.03231781511812601
11,20,0,1,20,21,0.010303404424486018,0.007046943367739398
11,21,0,1,21,22,0.2660747992356009,0.18198004897681613
11,22,0,2,24,26,0.6934334238224719,0.47426907317756356
11,23,0,2,25,27,0.9386164915841005,0.6419603645277039
11,24,0,2,22,24,0.9912288709436826,0.6779442434976387
11,25,0,2,23,25,0.6689426580998307,0.45751878055875905
11,26,0,3,20,23,0.9773837589942238,0.6684749733604806
11,27,0,2,28,30,0.6815660900231499,0.4661524909524557
11,28,0,2,27,29,0.741374737724527,0.5070582087025095
11,29,0,1,3,4,1.2188744972515761,0.8336409210630558
11,30,0,2,21,23,1.5704224701448737,1.0740797657361099
11,31,0,2,9,11,1.89206218605872,1.294063061497475
11,32,0,1,2,3,2.3804059952251024,1.6280624878427437
11,33,0,1,5,6,1.5419309389230644,1.0545931767691545
11,34,0,3,7,10,3.2302961734267583,2.2093390938887865
11,35,0,0,2,2,0.7122077786540786,0.48710966545304124
11,36,0,1,2,3,1.8692759262264622,1.278478554087583
11,37,0,2,3,5,2.3270677980971435,1.591582190747466
11,38,0,2,32,34,0.7919834253754899,0.5416716763583459
11,39,0,2,30,32,1.425891804546055,0.9752290001623454
11,40,0,2,10,12,3.321695183967079,2.2718508254106897
11,41,0,0,3,3,1.765920396796628,1.2077892428048127
11,42,0,1,7,8,2.9636781544253132,2.026987513448346
11,43,0,2,26,28,0.6314741152965391,0.43189242558631635
11,44,0,1,4,5,1.6573123665018805,1.1335075192853568
11,45,0,1,7,8,1.7373934562568578,1.1882784358757081
11,46,0,1,8,9,0.5611195158886484,0.3837738759048959
11,47,0,1,12,13,1.2806141359354701,0.8758673269601336
11,48,0,3,21,24,0.9573661765186232,0.6547840839948865
11,49,0,2,29,31,1.0488711740704473,0.7173683046123358
11,50,0,1,10,11,1.4739911103491872,1.0081261931733012
11,51,0,1,1,2,2.710692081830764,1.8539594100222758
11,52,0,2,31,33,1.3997085410898942,0.9573211352318305
11,53,0,2,2,4,2.5621418921507524,1.7523595182957887
11,54,0,3,8,11,2.840976009312869,1.9430662159738301
11,55,0,2,8,10,3.7475784192281365,2.563130767118308
11,56,0,1,6,7,1.9497619715139922,1.3335264372597344
11,57,0,0,4,4,1.0829589096544707,0.7406823794849304
11,58,0,2,1,3,4.133597142490917,2.827145647021033
11,59,0,2,8,10,0.9543814549767667,0.6527427039997512
11,60,0,2,7,9,1.4960218939282435,1.023193997738905
11,61,0,1,9,10,1.0276934592347302,0.702883950610782
11,62,0,2,8,10,0.7780596760558487,0.5321486227267782
11,63,0,2,9,11,0.9897726725418609,0.6769482865064288
11,64,0,1,19,20,2.0881896258683463,1.4282030898082727
11,65,0,1,18,19,1.9404048678111974,1.3271267098334327
11,66,0,1,17,18,2.370843612301821,1.6215223610899918
11,67,0,1,16,17,2.236635145409649,1.5297313931054033
11,68,0,1,15,16,2.778730980603156,1.9004941520064838
11,69,0,1,14,15,2.993170405581595,2.0471585380071375
11,70,0,2,6,8,3.1850613733254005,2.1784010600669044
11,71,0,2,5,7,3.3681852317562515,2.303647377349894
11,72,0,2,4,6,3.4862029647040216,2.384364802989858
11,73,0,1,13,14,1.244217811640216,0.850974308542551
11,74,0,1,11,12,1.706421753054757,1.1670955501540767
11,75,0,0,5,5,0.3223913046146711,0.22049733974064986
11,76,0,0,6,6,3.7942784751521006,2.5950709526927334
11,77,0,1,9,10,1.4217138865443006,0.9723715415651216
11,78,0,1,3,4,11.87497748839405,8.121810074252965
12,0,1,0,0,1,0.00011056665145006357,7.562130913521307e-05
12,1,0,0,8,8,1.3130128272742465,0.8980261915108295
12,2,0,1,7,8,3.6583778892924936,2.5021226714509215
12,3,0,1,6,7,3.87849378915883,2.652669443837219
12,4,0,1,7,8,4.080004667255942,2.790491438144176
12,5,0,0,11,11,0.7007549108445958,0.4792765544222999
12,6,0,0,10,10,1.2282912097031535,0.8400814174876016
12,7,0,1,9,10,0.5125373958897939,0.35054646540909506
12,8,0,0,5,5,4.263638786585859,2.9160867448980574
12,9,0,0,4,4,7.158590545329369,4.896069307527667
12,10,0,0,3,3,6.670192254781307,4.562032619012006
12,11,0,0,1,1,0.05910429789643802,0.040423982492269764
12,13,0,0,2,2,0.004252265677127993,0.0029083081840493522
12,14,0,2,21,23,0.19316668464193185,0.1321150399542406
12,15,0,1,1,2,0.2287980275333859,0.15648485454444155
12,16,0,2,7,9,8.821725864150519,6.03355939544145
12,17,0,2,7,9,9.017567794345648,6.167504151393576
12,18,0,0,9,9,0.3295429244020458,0.22538864144569273
12,19,0,1,2,3,0.02694164048187615,0.01842655173843158
12,20,0,1,21,22,0.007437314664211869,0.005086700772630623
12,21,0,1,22,23,0.4471601149111433,0.3058321188093964
12,22,0,2,25,27,0.8274163982741988,0.5659058171414106
12,23,0,2,26,28,1.408655031965501,0.9634400268081497
12,24,0,2,23,25,0.8666578734033883,0.5927447571178688
12,25,0,2,24,26,0.6824879120193338,0.4667829648360981
12,26,0,3,21,24,0.7341216301821073,0.502097495137769
12,27,0,2,29,31,0.8216260977138229,0.5619455804613684
12,28,0,2,28,30,0.7500028935129368,0.5129593771613988
12,29,0,1,4,5,0.7232296875605383,0.4946480250736361
12,30,0,2,22,24,2.2569053903275678,1.5435950892296975
12,31,0,2,10,12,1.0673661964445733,0.7300178493536645
12,32,0,1,1,2,1.012629254068269,0.692580889960675
12,33,0,1,6,7,1.0038344850967156,0.6865657675485524
12,34,0,3,8,11,1.8596267920084277,1.271879094376906
12,35,0,0,1,1,0.39653222307862157,0.2712055165842185
12,36,0,1,3,4,1.0936066628089924,0.7479648378241628
12,37,0,2,4,6,1.362597789787056,0.9319394893222642
12,38,0,2,33,35,1.2554717404974671,0.8586713566301857
12,39,0,2,31,33,0.7697715409838443,0.5264800091239007
12,40,0,2,11,13,1.7409578429225077,1.1907162738891193
12,41,0,0,2,2,0.9496159248158821,0.6494833520634923
12,42,0,1,8,9,1.765417098270037,1.2074450152012135
12,43,0,2,27,29,0.5447753831429214,0.37259541749359293
12,44,0,1,5,6,1.0202632835292047,0.6978021324803825
12,45,0,1,8,9,1.298599703479127,0.8881684335357035
12,46,0,1,9,10,0.5135034350204268,0.3512071813010592
12,47,0,1,13,14,1.9064299904905961,1.303889823602393
12,48,0,3,22,25,0.7070646338755451,0.4835920465677457
12,49,0,2,30,32,1.6107103262542402,1.1016343708660064
12,50,0,1,11,12,1.56811433942069,1.0725011354282472
12,51,0,1,0,1,1.1983568032008571,0.8196079837876433
12,52,0,2,32,34,1.2993921655912815,0.8887104326066281
12,53,0,2,3,5,1.5099593040351849,1.0327263945730198
12,54,0,3,9,12,1.6206290104701924,1.1084181874641588
12,55,0,2,9,11,2.170919750240315,1.4847857956049912
12,56,0,1,7,8,1.358433007802148,0.9290910150144056
12,57,0,0,3,3,1.8491781958480908,1.264732848109091
12,58,0,2,2,4,2.501605837582775,1.7109562955674726
12,59,0,2,9,11,0.9087339328573448,0.6215223917611346
12,60,0,2,8,10,0.8570651934753706,0.5861839089348213
12,61,0,1,10,11,1.030186242840362,0.7045888730008194
12,62,0,2,9,11,0.6927278692433605,0.4737865139226798
12,63,0,2,10,12,1.0254029681864263,0.701317384839244
12,64,0,1,20,21,1.5409483066194887,1.0539211120894305
12,65,0,1,19,20,1.3255029263688933,0.9065687098233455
12,66,0,1,18,19,1.5104137344564548,1.0330371991684073
12,67,0,1,17,18,1.3460021551831975,0.920589017925921
12,68,0,1,16,17,1.6119286382929547,1.1024676270973792
12,69,0,1,15,16,1.7158951243610792,1.1735747980169062
12,70,0,2,7,9,1.8301829185374126,1.2517411574068664
12,71,0,2,6,8,1.9537460747215323,1.3362513375468705
12,72,0,2,5,7,2.0834843695251366,1.424984961739603
12,73,0,1,14,15,1.8913011477176582,1.2935425545010306
12,74,0,1,12,13,1.8253251824493284,1.2484187418539254
12,75,0,0,6,6,0.1926361900672764,0.13175221179856753
12,76,0,0,7,7,2.329664305873536,1.5933580545785169
12,77,0,1,10,11,1.4806656463134542,1.0126911966428682
12,78,0,1,2,3,4.937459697663518,3.3769419733969332
13,0,1,0,0,1,0.0004868254605198259,0.0003329609621169463
13,1,0,0,6,6,0.7194557189864901,0.49206684493964625
13,2,0,1,5,6,2.650461193999086,1.81276490400737
13,3,0,1,4,5,2.7275357617264677,1.8654795303086615
13,4,0,1,5,6,2.751659687557931,1.8819789252793047
13,5,0,0,9,9,0.1205829879650781,0.0824719143590344
13,6,0,0,8,8,0.22070758960204337,0.15095145455609493
13,7,0,1,7,8,0.2347771152552279,0.1605742109193534
13,8,0,0,3,3,2.54993112854653,1.744008049591783
13,9,0,0,2,2,4.865989615512102,3.3280604968810934
13,10,0,0,1,1,4.757513570732607,3.25386904395697
13,11,0,0,1,1,0.07394178645421799,0.050571981860097426
13,12,0,0,2,2,0.0009891971919428536,0.0006765546904654152
13,14,0,2,19,21,0.05005665724197294,0.03423591021276661
13,15,0,1,1,2,0.32636501057787237,0.22321512890324743
13,16,0,2,5,7,6.37046134732625,4.357033703762468
13,17,0,2,5,7,6.063718140378097,4.14723877397544
13,18,0,0,7,7,0.1511778693254384,0.10339707534531876
13,19,0,1,0,1,0.019139784946236558,0.013090525716558816
13,20,0,1,19,20,0.0017658759490410318,0.0012077588430647263
13,21,0,1,20,21,0.3492581081151641,0.23887270723473925
13,22,0,2,23,25,0.5060968958136868,0.34614152919321794
13,23,0,2,24,26,1.025848212279615,0.70162190650803
13,24,0,2,21,23,0.3469926538764633,0.2373232652188178
13,25,0,2,22,24,0.35328990033073177,0.24163022409451393
13,26,0,3,19,22,0.1834174891024353,0.1254471439834118
13,27,0,2,27,29,0.5197540901581355,0.35548227436272933
13,28,0,2,26,28,0.40130132286862846,0.2744673099440333
13,29,0,1,2,3,0.26931240696183384,0.1841943887575103
13,30,0,2,20,22,1.5873435599739043,1.0856528300198172
13,31,0,2,8,10,0.8758591983367839,0.5990379407145169
13,32,0,1,3,4,0.9548708322329122,0.6530774102451279
13,33,0,1,4,5,0.1200850039066715,0.08213132154979857
13,34,0,3,6,9,1.3128719711000003,0.8979298538886207
13,35,0,0,3,3,0.6057705094556788,0.4143126192189396
13,36,0,1,1,2,0.5367890712029659,0.36713323376874357
13,37,0,2,2,4,0.7846902661150398,0.5366835696935083
13,38,0,2,31,33,0.9625214367402092,0.6583099891550431
13,39,0,2,29,31,0.1691025695024936,0.11565655209954874
13,40,0,2,9,11,1.1785979358350303,0.8060940408614826
13,41,0,0,4,4,1.5334861964474238,1.048817452597874
13,42,0,1,6,7,1.2274327765097688,0.8394942979444345
13,43,0,2,25,27,0.23115284886920112,0.15809541857851928
13,44,0,1,3,4,0.23830082368879538,0.16298422733264334
13,45,0,1,6,7,0.2560058884339058,0.17509348592725357
13,46,0,1,7,8,0.20747155092793912,0.14189875594242538
13,47,0,1,11,12,1.3748201029591784,0.9402988572746697
13,48,0,3,20,23,0.19570633584227087,0.13385201711686356
13,49,0,2,28,30,1.1988900585328832,0.81997270014454
13,50,0,1,9,10,0.816079123275043,0.5581517650269782
13,51,0,1,2,3,1.1465395550912705,0.7841679294273027
13,52,0,2,30,32,0.6902579228085687,0.47209721086028966
13,53,0,2,1,3,0.968891418584391,0.6626666949058918
13,54,0,3,7,10,1.0875434719998276,0.7438179597147836
13,55,0,2,7,9,1.7147346974516577,1.172781131925953
13,56,0,1,5,6,0.1639134025950772,0.11210745669226688
13,57,0,0,5,5,2.755580519600181,1.8846605516833395
13,58,0,2,0,2,1.8542407777783778,1.268195366582353
13,59,0,2,7,9,0.38615955269616753,0.2641111992357049
13,60,0,2,6,8,0.5913593512856131,0.40445620561969814
13,61,0,1,8,9,0.4918300300258616,0.33638380338726837
13,62,0,2,7,9,0.2628263418122567,0.17975828861958731
13,63,0,2,8,10,0.5043419749182088,0.34494126298451644
13,64,0,1,18,19,0.29864870251309494,0.20425874854112763
13,65,0,1,17,18,0.12568476986872007,0.08596124338741679
13,66,0,1,16,17,0.14048320515678184,0.09608253253707856
13,67,0,1,15,16,0.3021289308708132,0.20663902705231155
13,68,0,1,14,15,0.6065886717087684,0.41487219572643286
13,69,0,1,13,14,0.8541410653414054,0.5841839713888297
13,70,0,2,5,7,1.0716819826807538,0.7329696019919824
13,71,0,2,4,6,1.2762802602151282,0.8729032021421763
13,72,0,2,3,5,1.5673895716906008,1.0720054354694484
13,73,0,1,12,13,1.3844853116906648,0.9469093110394762
13,74,0,1,10,11,0.9637921397190287,0.659179077813514
13,75,0,0,4,4,0.13395057036105404,0.09161458140645855
13,76,0,0,5,5,1.6954781759777495,1.1596107650553875
13,77,0,1,8,9,0.7365306882053253,0.5037451539852535
13,78,0,1,4,5,4.643137668918901,3.1756424239477767
14,0,3,0,0,3,0.0005045920704532501,0.0003451123141244457
14,1,2,0,6,8,0.48954127685219206,0.3348184262232648
14,2,2,1,5,8,3.231616827328519,2.210242346141215
14,3,2,1,4,7,3.3609137903208373,2.298674124443755
14,4,2,1,5,8,3.441712194394199,2.353935643282671
14,5,2,0,9,11,0.2277417446667692,0.15576241706312988
14,6,2,0,8,10,0.2743650576405584,0.18765011481882304
14,7,2,1,7,10,0.14472671437890366,0.09898485180329179
14,8,2,0,3,5,1.822630920146583,1.2465760194795457
14,9,2,0,2,4,3.735723854362014,2.555022918118202
14,10,2,0,1,3,3.7474220168798236,2.5630237967960987
14,11,2,0,1,3,0.06422614585744088,0.0439270355640858
14,12,2,0,2,4,0.00101722763866808,0.0006957259238274368
14,13,2,0,0,2,0.001133144476332155,0.0007750064564293516
14,15,2,1,1,4,0.2974067252156409,0.20340930661702167
14,16,2,2,5,9,7.7640553550033085,5.310172845460394
14,17,2,2,5,9,7.580341037706277,5.184522687852447
14,18,2,0,7,9,0.09236688625410275,0.06317370353241851
14,19,1,0,19,20,0.02430231809786882,0.01662140514774688
14,20,1,0,0,1,0.00028812150346347785,0.00019705874236188142
14,21,1,0,1,2,0.27418892742216705,0.18752965175407119
14,22,0,0,4,4,0.33666077208621675,0.2302568449504823
14,23,0,0,5,5,0.7712136095717018,0.5274663021249673
14,24,0,0,2,2,0.1405727826048374,0.09614379842333014
14,25,0,0,3,3,0.20143143558272075,0.13776766013964262
14,26,0,1,0,1,0.014824071182362593,0.010138822645181959
14,27,0,0,8,8,0.34458390014060597,0.2356758144866037
14,28,0,0,7,7,0.22627196409655154,0.15475717064023753
14,29,1,0,17,18,0.42965407147254064,0.2938589794835398
14,30,0,0,1,1,1.1870007243194123,0.8118410708858316
14,31,1,1,27,29,1.0699154693256512,0.7317614071993779
14,32,2,1,3,6,1.227126266911077,0.8392846627894254
14,33,1,0,15,16,0.32454049148333547,0.22196726147973783
14,34,1,2,25,28,1.6631903850565166,1.137527750090876
14,35,2,0,3,5,0.645734697439097,0.44164585373582965
14,36,1,0,18,19,0.7669109287999835,0.5245235128799189
14,37,1,1,21,23,1.0548954310487133,0.7214885541929172
14,38,0,0,12,12,0.7217421827122543,0.4936306562513288
14,39,0,0,10,10,0.37278150354157336,0.2549613735199235
14,40,1,1,28,30,1.577790276581927,1.0791189268296018
14,41,2,0,4,6,1.6289870925260883,1.1141346408308581
14,42,2,1,6,9,1.538453162897957,1.0522145755141779
14,43,0,0,6,6,0.09455265528875366,0.06466864539508461
14,44,1,0,16,17,0.4684877449854637,0.3204190063186023
14,45,1,0,13,14,0.169652677803524,0.11603279492995454
14,46,1,0,12,13,0.10427740780139184,0.07131982372396607
14,47,1,0,8,9,1.067479756974374,0.7300955183055318
14,48,0,1,1,2,0.026120300686358563,0.017864801972409767
14,49,0,0,9,9,0.898604714918339,0.6145945820552445
14,50,1,0,10,11,0.509219691954281,0.3482773443709144
14,51,2,1,2,5,1.4512102827372133,0.99254540109352
14,52,0,0,11,11,0.3661365865356807,0.25041662773545525
14,53,1,1,20,22,1.2513763692935547,0.8558703553538255
14,54,1,2,26,29,1.4060379520771686,0.9616500928210785
14,55,1,1,26,28,2.0958994301940166,1.4334761580312607
14,56,1,0,14,15,0.2848297010142757,0.1948073364690694
14,57,2,0,5,7,2.5750572809162904,1.7611929105856994
14,58,1,1,19,21,2.2660662453630307,1.549860593714949
14,59,2,2,7,11,0.22844152039298438,0.15624102391088573
14,60,1,1,25,27,0.7562186124218075,0.5172105758270072
14,61,1,0,11,12,0.2864516876582536,0.19591668320073594
14,62,1,1,12,14,0.12512473115698367,0.0855782087201597
14,63,2,2,8,12,0.3222762191835556,0.22041862784290128
14,64,1,0,1,2,0.15094633984550637,0.10323872233248686
14,65,1,0,2,3,0.25979499364056874,0.17768501865815406
14,66,1,0,3,4,0.48777812088780365,0.33361252769520067
14,67,1,0,4,5,0.6258081932792112,0.42801725676471314
14,68,1,0,5,6,0.980378386609539,0.6705231285471724
14,69,1,0,6,7,1.2289218542235572,0.8405127425174044
14,70,1,1,24,26,1.4468091568303905,0.989535280967985
14,71,1,1,23,25,1.6515639933237125,1.1295759585531666
14,72,1,1,22,24,1.917764631167119,1.3116420739897807
14,73,1,0,7,8,1.0783314486906586,0.7375174590368003
14,74,1,0,9,10,0.5982184501454195,0.4091474396261895
14,75,2,0,4,6,0.16765048124350146,0.11466340621256806
14,76,2,0,5,7,2.069552770210565,1.415456539157402
14,77,2,1,8,11,0.46666524574023094,0.3191725203572844
14,78,2,1,4,7,6.006732414091884,4.108263774124508
15,0,2,0,0,2,0.0008363726026070172,0.0005720313521707147
15,1,1,0,7,8,1.5965508043207812,1.0919500621590494
15,2,1,1,6,8,6.458295997502595,4.417107615259811
15,3,1,1,5,7,6.910408441959906,4.726326846174337
15,4,1,1,6,8,7.353665416306523,5.029489438545542
15,5,1,0,10,11,1.2383019559704949,0.8469281992995543
15,6,1,0,9,10,2.0691379112812904,1.4151727992147816
15,7,1,1,8,10,0.6852747399677248,0.4686889968541439
15,8,1,0,4,5,4.878492603524641,3.336611830481326
15,9,1,0,3,4,7.313911175431293,5.002299795925143
15,10,1,0,2,3,6.476864904960123,4.429807693201332
15,11,1,0,0,1,0.022781185160676422,0.015581036622784056
15,12,1,0,1,2,0.0013339571042056328,0.0009123508872456657
15,13,1,0,1,2,0.008179574199946676,0.005594364132913469
15,14,1,2,20,23,0.3292717314887452,0.22520316089741685
15,16,1,2,6,9,15.532790137140347,10.623546153277335
15,17,1,2,6,9,16.210215124425876,11.086866365182036
15,18,1,0,8,9,0.44122683808346985,0.30177409448392495
15,19,1,1,1,3,0.05176426127918053,0.03540381437812459
15,20,1,1,20,22,0.013054440296139213,0.008928495638374135
15,21,1,1,21,23,0.40357241624405055,0.27602060880915535
15,22,1,2,24,27,0.9848241385232075,0.6735637703265233
15,23,1,2,25,28,1.4003254573823918,0.9577430709335425
15,24,1,2,22,25,1.3085825749388622,0.8949961505626111
15,25,1,2,23,26,0.9165395598419652,0.6268609972398826
15,26,1,3,20,24,1.243146644707258,0.8502416912053132
15,27,1,2,28,31,0.979727233156703,0.6700777765725436
15,28,1,2,27,30,1.0221165404307977,0.6990696549315405
15,29,1,1,3,5,1.4037576847362536,0.960090519484663
15,30,1,2,21,24,2.298207705881118,1.571843526995634
15,31,1,2,9,12,2.0381233218148735,1.393960581724403
15,32,1,1,2,4,2.6014521568216247,1.7792455064113433
15,33,1,1,5,7,1.8534276024574095,1.2676392008531607
15,34,1,3,7,11,3.5396808158049757,2.420940615469976
15,35,1,0,2,3,0.6785552666681273,0.4640932587997617
15,36,1,1,2,4,2.1159687978044195,1.447202465487537
15,37,1,2,3,6,2.6008408349815233,1.7788273969972919
15,38,1,2,32,35,1.2274833206809266,0.8395288672864739
15,39,1,2,30,33,1.6884576615039413,1.1548091319377212
15,40,1,2,10,13,3.674555362832138,2.513187144431915
15,41,1,0,3,4,1.672163325426037,1.1436647316186364
15,42,1,1,7,9,3.2490649704863865,2.2221758849639253
15,43,1,2,26,29,0.8380636760702895,0.5731879503624779
15,44,1,1,4,6,1.9491354661774618,1.333097943196585
15,45,1,1,7,9,2.1735876870055852,1.4866105128070928
15,46,1,1,8,10,0.7385767093237883,0.5051445162112711
15,47,1,1,12,14,1.850025951695779,1.265312664954301
15,48,1,3,21,25,1.2225524180255936,0.8361564099575749
15,49,1,2,29,32,1.5916435158767976,1.0885937556093683
15,50,1,1,10,12,2.0087234069591933,1.373852709950295
15,51,1,1,1,3,2.940580536031769,2.0111900544684636
15,52,1,2,31,34,1.9120010460248185,1.3077001091382008
15,53,1,2,2,5,2.834101958158578,1.9383647554472383
15,54,1,3,8,12,3.1312569363033504,2.141601881367636
15,55,1,2,8,11,4.049948984476163,2.7699350583592093
15,56,1,1,6,8,2.3923571600129208,1.6362364057021777
15,57,1,0,4,5,0.47051036120366146,0.32180236092229414
15,58,1,2,1,4,4.494304808450902,3.0738492014586996
15,59,1,2,8,11,1.2543284553127725,0.8578894145052532
15,60,1,2,7,10,1.6437680126793686,1.124243950623232
15,61,1,1,9,11,1.3817949669554759,0.9450692680587777
15,62,1,2,8,11,1.0172142318058814,0.6957167542952358
15,63,1,2,9,12,1.3262930626305258,0.9071091181446269
15,64,1,1,19,21,2.620033719258403,1.791954239639839
15,65,1,1,18,20,2.3836352319399277,1.630271102327129
15,66,1,1,17,19,2.8501309046198893,1.9493276443433543
15,67,1,1,16,18,2.6301335591681463,1.7988619564424573
15,68,1,1,15,17,3.197101884392125,2.1866360857060223
15,69,1,1,14,16,3.384976750590883,2.315131822433382
15,70,1,2,6,9,3.555648733289161,2.4318617640123334
15,71,1,2,5,8,3.7204538627905417,2.544579111256239
15,72,1,2,4,7,3.7851414777976853,2.5888217655061436
15,73,1,1,13,15,1.8098404377875044,1.2378280560766637
15,74,1,1,11,13,2.335755924705302,1.597524375840574
15,75,1,0,5,6,0.35339823381781754,0.2417043180460732
15,76,1,0,6,7,4.133053459518119,2.8267737987501644
15,77,1,1,9,11,1.9122237404361588,1.3078524194659698
15,78,1,1,3,5,13.028589212590688,8.910814965631811
16,0,3,0,0,3,0.0009362221914962462,0.0006403227992697213
16,1,2,0,1,3,1.7997224478131282,1.2309079256608044
16,2,1,0,0,1,0.024305555555555556,0.01662361938490908
16,3,2,1,1,4,0.16820911599374636,0.11504548064991338
16,4,2,1,2,5,0.40984153524338524,0.2803083301033852
16,5,2,0,4,6,0.663267900925163,0.453637568991394
16,6,2,0,3,5,1.3214445258936662,0.9037929944253779
16,7,2,1,2,5,0.6793950206787276,0.4646676028429275
16,8,2,0,2,4,5.9182446582336175,4.047743175438732
16,9,2,0,3,5,10.027816251080395,6.858456711213244
16,10,2,0,4,6,9.351884447647224,6.396157752247054
16,11,2,0,6,8,0.12646730798983752,0.08649645501217906
16,12,2,0,7,9,0.0016591339581004286,0.0011347533844678988
16,13,2,0,5,7,0.0051503446902144475,0.00352254321591274
16,14,2,2,24,28,0.27728769125011815,0.18964903019501408
16,15,2,1,6,9,0.5010577463593661,0.34269503720249467
16,17,2,2,2,6,0.9,0.6155488777954903
16,18,2,0,2,4,0.4396190374814417,0.3006744501991501
16,19,2,1,5,8,0.005584050134079681,0.0038191731039850054
16,20,2,1,24,27,0.010787674870098494,0.0073781568447908235
16,21,2,1,25,28,0.6889330206569653,0.47119105304628045
16,22,2,2,28,32,1.2734585841856654,0.8709733360161337
16,23,2,2,29,33,2.177808816142827,1.4894975253664917
16,24,2,2,26,30,1.2863374064305375,0.8797817188829767
16,25,2,2,27,31,1.0420119937992998,0.7126770149251116
16,26,2,3,24,29,1.029923885477244,0.7044094354669874
16,27,2,2,32,36,1.314380679704535,0.8989617248757783
16,28,2,2,31,35,1.1966447051431859,0.8184370059675595
16,29,2,1,7,10,0.4719506056284601,0.3227874062994452
16,30,2,2,25,29,3.3983832512428296,2.3243011073572375
16,31,2,2,13,17,0.24256148616451936,0.16589827844997362
16,32,2,1,8,11,1.021115926428763,0.6983852917914751
16,33,2,1,9,12,1.0159001236462615,0.694817978958618
16,34,2,3,11,16,0.34671699354244395,0.23713472920853074
16,35,2,0,8,10,0.5653646575974891,0.38667731169929576
16,36,2,1,6,9,0.5164040253031541,0.35319102029381166
16,37,2,2,7,11,0.44854371829470996,0.3067784249316947
16,38,2,2,36,40,2.060371879782005,1.4091773316013314
16,39,2,2,34,38,0.9664112050695349,0.6609703697439331
16,40,2,2,14,18,0.8290092955158122,0.5669952683742092
16,41,2,0,9,11,1.4929070590811013,1.0210636276337088
16,42,2,1,3,6,0.2032823925935199,0.1390336095961372
16,43,2,2,30,34,0.8555080263115183,0.5851188950456556
16,44,2,1,8,11,0.8624117978893403,0.5898406826537496
16,45,2,1,11,14,1.5880501327453682,1.0861360856604343
16,46,2,1,12,15,0.7056199795609217,0.4826039850764469
16,47,2,1,16,19,2.76669021756053,1.8922589540301613
16,48,2,3,25,30,1.0565643953705843,0.7226300309878156
16,49,2,2,33,37,2.560702455641133,1.7513750254867286
16,50,2,1,14,17,2.2353828970694396,1.528874926371473
16,51,2,1,7,10,1.0349890129583232,0.7078736949523979
16,52,2,2,35,39,2.2177484077324916,1.5168139373471898
16,53,2,2,6,10,0.32121370941733024,0.21969193151596045
16,54,2,3,12,17,0.3995269528357763,0.27325374163012656
16,55,2,2,12,16,0.3477272727272727,0.23782570278462128
16,56,2,1,10,13,1.5379963238927759,1.0519021235842085
16,57,2,0,10,12,3.9487851296316445,2.7007447280003096
16,58,2,2,5,9,0.12992508118331933,0.08886137546653355
16,59,2,2,2,6,1.1886010430740834,0.8129355980120017
16,60,2,2,11,15,0.18373396510890555,0.1256635955952251
16,61,2,1,13,16,1.4517134902785307,0.9928895664683602
16,62,2,2,12,16,0.9412809980847229,0.6437827356236338
16,63,2,2,3,7,1.3809652093000213,0.9445017609547142
16,64,2,1,23,26,1.9725892372179936,1.3491389903566648
16,65,2,1,22,25,1.5704886114708903,1.074125002646116
16,66,2,1,21,24,1.5951015302796592,1.0909588410372375
16,67,2,1,20,23,1.1941199243789662,0.816710199338565
16,68,2,1,19,22,1.0997851896298119,0.752190599214146
16,69,2,1,18,21,0.854176064428972,0.5842079087766913
16,70,2,2,10,14,0.6420544654025602,0.4391287840690328
16,71,2,2,9,13,0.44874954699823644,0.3069192000733324
16,72,2,2,8,12,0.1688657010763287,0.11549454755075873
16,73,2,1,17,20,2.7694501787936296,1.8941466107410434
16,74,2,1,15,18,2.642884478924746,1.8075828612724967
16,75,2,0,1,3,0.020841347736042976,0.014254298011852044
16,76,2,0,0,2,0.04264502940746161,0.02916677777257631
16,77,2,1,3,6,2.0210488442262986,1.3822826089259679
16,78,2,1,9,12,5.447355615229255,3.7256818176748125
17,0,3,0,0,3,0.0008670003163130444,0.0005929789686164775
17,1,2,0,2,4,1.654986904018961,1.1319170350390049
17,2,2,1,1,4,0.3446082159944307,0.2356924451494198
17,3,1,0,1,2,0.20956933626701593,0.14333352195500826
17,4,1,0,0,1,0.024793388429752067,0.016957269360757313
17,5,2,0,5,7,0.5714315832511043,0.39082674423013075
17,6,2,0,4,6,1.1607324492266966,0.7938750628247824
17,7,2,1,3,6,0.6193951254213871,0.4236310826279243
17,8,2,0,1,3,5.4682498295475765,3.739972273425992
17,9,2,0,2,4,9.340319082932211,6.38824769972303
17,10,2,0,3,5,8.740775615470637,5.97819402351682
17,11,2,0,5,7,0.11991889703683604,0.08201771388610822
17,12,2,0,6,8,0.001554636104772715,0.0010632827885257744
17,13,2,0,4,6,0.00449382188968113,0.003073518912451144
17,14,2,2,23,27,0.2481659268296698,0.16973139751897892
17,15,2,1,5,8,0.47933431819538874,0.3278374462822645
17,16,2,2,1,5,0.825,0.5642531379791995
17,18,2,0,3,5,0.4007965924215574,0.2741221029881625
17,19,2,1,4,7,0.0039938556067588326,0.0027315703742418077
17,20,2,1,23,26,0.009636559430804714,0.006590859270490434
17,21,2,1,24,27,0.6449571973023022,0.44111408780617417
17,22,2,2,27,31,1.1739511966435427,0.8029159352006731
17,23,2,2,28,32,2.0285208143410496,1.3873930120582527
17,24,2,2,25,29,1.165013526005185,0.7968030761656213
17,25,2,2,26,30,0.9528821911308518,0.6517172926910042
17,26,2,3,23,28,0.920977071067515,0.6298960028566516
17,27,2,2,31,35,1.2121249777995482,0.8290246331471063
17,28,2,2,30,34,1.0945780595609533,0.7486292180247892
17,29,2,1,6,9,0.37694284316657994,0.2578074934491442
17,30,2,2,24,28,3.1621726859527066,2.162746498037489
17,31,2,2,12,16,0.2650791417404102,0.18129907580589028
17,32,2,1,7,10,0.9107175727206677,0.6228790887520442
17,33,2,1,8,11,0.8749635560923642,0.598425372294007
17,34,2,3,10,15,0.23704268837302514,0.1621237342418242
17,35,2,0,7,9,0.5667272589950364,0.38760925365612103
17,36,2,1,5,8,0.38196762049206745,0.2612441557201176
17,37,2,2,6,10,0.29337552514022147,0.2006521947474733
17,38,2,2,35,39,1.9197300348379038,1.312986298460855
17,39,2,2,33,37,0.8362091581493468,0.5719195654457135
17,40,2,2,13,17,0.6550304234582605,0.4480036023129301
17,41,2,0,8,10,1.4873446262411765,1.0172592395310105
17,42,1,0,1,2,0.10212085688120176,0.06984486539193069
17,43,2,2,29,33,0.7756607544028509,0.5305078965807537
17,44,2,1,7,10,0.7220578379655755,0.493846546514609
17,45,2,1,10,13,1.4090721320294146,0.9637252995595612
17,46,2,1,11,14,0.6397183407997269,0.43753100753829444
17,47,2,1,15,18,2.5834899726837484,1.7669603927570927
17,48,2,3,24,29,0.9468336943309507,0.6475804644493056
17,49,2,2,32,36,2.3852397410845265,1.631368495441985
17,50,2,1,13,16,2.048105219944792,1.400787633049003
17,51,2,1,6,9,0.9334867805408089,0.6384519335542446
17,52,2,2,34,38,2.0236412725579602,1.3840556826485448
17,53,2,2,5,9,0.16811431289993173,0.11498064071879212
17,54,2,3,11,16,0.258722103716191,0.17695122289265536
17,55,2,2,11,15,0.41417297859511204,0.2832707913193743
17,56,2,1,9,12,1.3480892680220449,0.922016484554571
17,57,2,0,9,11,3.80064468215591,2.599425076667188
17,58,2,2,4,8,0.2730726560998363,0.18676618557654234
17,59,2,2,3,7,1.080048868988294,0.7386920769667034
17,60,2,2,10,14,0.12017304580520846,0.08219153720740235
17,61,2,1,12,15,1.3249545661023139,0.9061936625492115
17,62,2,2,11,15,0.8514164183026847,0.5823204675809704
17,63,2,2,4,8,1.2631092634201797,0.8638949884793112
17,64,2,1,22,25,1.752654350862411,1.198716020929712
17,65,2,1,21,24,1.3782504416052825,0.9426450140569675
17,66,2,1,20,23,1.3757716121140817,0.940949635488573
17,67,2,1,19,22,1.0027922746967122,0.6858529548350537
17,68,2,1,18,21,0.8825577845017819,0.6036193931552735
17,69,2,1,17,20,0.6399129629313279,0.4376641180212957
17,70,2,2,9,13,0.43449450529040184,0.29716956126645955
17,71,2,2,8,12,0.2620843709084725,0.1792508226671637
17,72,2,2,7,11,0.261680267693229,0.1789744390219896
17,73,2,1,16,19,2.587669269867435,1.7698187946364174
17,74,2,1,14,17,2.4223121313865077,1.6567239046059636
17,75,2,0,0,2,0.010163780731571388,0.0069514486927535505
17,76,2,0,1,3,0.22063238916342084,0.15090002172764627
17,77,2,1,4,7,1.8491938751899768,1.2647435718883162
17,78,2,1,8,11,4.845518189065954,3.3140592040190944
18,0,1,0,0,1,0.0006911908660773392,0.0004727352910626659
18,1,0,0,1,1,0.16087851094543054,0.11003176319318811
18,2,0,1,2,3,3.892362659827228,2.6621549635885784
18,3,0,1,3,4,4.079552488668988,2.79018217367555
18,4,0,1,4,5,4.223148582418548,2.888393745190393
18,5,0,0,2,2,0.3766645014424456,0.2576171235203281
18,6,0,0,1,1,0.49841892455530407,0.34089023298005844
18,7,0,1,0,1,0.0036363636363636364,0.0024870661729110726
18,8,0,0,4,4,0.8227774972113393,0.562733072315358
18,9,0,0,5,5,2.2432275475856023,1.534240221729164
18,10,0,0,6,6,2.4322240990454485,1.663503127460637
18,11,0,0,8,8,0.06266905814442864,0.04286207601478154
18,12,0,0,9,9,0.001317039560072623,0.0009007802480166326
18,13,0,0,7,7,0.0025972428839563144,0.0017763666028684805
18,14,0,2,26,28,0.07009986903213156,0.047944328573710476
18,15,0,1,8,9,0.302453880944314,0.20686127444462593
18,16,0,2,2,4,9.341904546480636,6.3893320667319395
18,17,0,2,4,6,9.29119373340883,6.35464875108922
18,19,0,1,7,8,0.030630031414418543,0.020949201626651058
18,20,0,1,26,27,0.0030676130526786903,0.0020980730800968517
18,21,0,1,27,28,0.1956691896037904,0.13382661119974024
18,22,0,2,30,32,0.17640655754114123,0.12065206503357233
18,23,0,2,31,33,0.5075848031758433,0.3471591733121503
18,24,0,2,28,30,0.17433217884547014,0.11923330783552431
18,25,0,2,29,31,0.10445376315308605,0.07144044076710895
18,26,0,3,26,29,0.2571760217688257,0.1758937906618992
18,27,0,2,34,36,0.20666519656735194,0.14134725536268658
18,28,0,2,33,35,0.1562152739188955,0.10684237395032362
18,29,0,1,9,10,0.6166937641487391,0.42178350496137024
18,30,0,2,27,29,0.7415496178395932,0.5071778167675959
18,31,0,2,15,17,1.319126967687028,0.9022079162550204
18,32,0,1,10,11,1.675871879608359,1.1462011720243828
18,33,0,1,11,12,0.5923887995193007,0.4051602897363592
18,34,0,3,13,16,2.088138209160389,1.4281679237006248
18,35,0,0,10,10,0.7440004469943089,0.5088540446963223
18,36,0,1,8,9,1.0349990943560246,0.7078805900557775
18,37,0,2,9,11,1.3696663652631595,0.9367739934355178
18,38,0,2,38,40,0.5148511984125161,0.3521289749049863
18,39,0,2,36,38,0.6928439890840337,0.4738659332978088
18,40,0,2,16,18,2.1045066326382447,1.439362995592931
18,41,0,0,11,11,1.8836996677928977,1.2883435740151736
18,42,0,1,5,6,1.9019924936277184,1.300854827808876
18,43,0,2,32,34,0.14197127469394863,0.09710028757450598
18,44,0,1,10,11,0.740795527231015,0.5066620616255222
18,45,0,1,13,14,0.45304707709494413,0.30985846654924426
18,46,0,1,14,15,0.05293602008294751,0.03620523084113098
18,47,0,1,18,19,0.6943654276033294,0.4749065108235725
18,48,0,3,27,30,0.2772581069485246,0.18962879621318485
18,49,0,2,35,37,0.6127108133665723,0.4190593928677286
18,50,0,1,16,17,0.14138736443817454,0.09670092612708929
18,51,0,1,9,10,1.9373006169811526,1.325003578594733
18,52,0,2,37,39,0.4070626487409524,0.2784077295832813
18,53,0,2,8,10,1.5810223138433608,1.0813294567287892
18,54,0,3,14,17,1.7926363975087347,1.2260614697576138
18,55,0,2,14,16,2.568952016447547,1.7570172564830548
18,56,0,1,12,13,0.6271530960755594,0.42893709388364215
18,57,0,0,12,12,2.6635412517924326,1.8217109205586977
18,58,0,2,7,9,2.7473128757557537,1.8790059529161731
18,59,0,2,0,2,0.04093893575130367,0.027999906622062948
18,60,0,2,13,15,0.9563266941097974,0.6540731370723966
18,61,0,1,15,16,0.061605198855045964,0.0421344566906573
18,62,0,2,14,16,0.08946581599362383,0.061189536262147765
18,63,0,2,1,3,0.0465657314657332,0.03184831527495359
18,64,0,1,25,26,0.5620835334689487,0.3844332091712615
18,65,0,1,24,25,0.6429609184668856,0.439748746476277
18,66,0,1,23,24,0.9317692618188305,0.6372772483076817
18,67,0,1,22,23,1.0159141715735174,0.6948275869429044
18,68,0,1,21,22,1.4267461832982495,0.9758133466980407
18,69,0,1,20,21,1.6753537025652165,1.1458467683605988
18,70,0,2,12,14,1.8931861447567642,1.29483178540333
18,71,0,2,11,13,2.0978556874417342,1.4348141268684962
18,72,0,2,10,12,2.334126539283783,1.5964099687653381
18,73,0,1,19,20,0.7147332095054044,0.4888369167046898
18,74,0,1,17,18,0.19256032880526516,0.13170032700445736
18,75,0,0,3,3,0.2069160889241078,0.14151885148340715
18,76,0,0,2,2,2.4978885375544517,1.7084138734998462
18,77,0,1,1,2,0.07627042582114166,0.052164638914653276
18,78,0,1,11,12,8.308035418693292,5.68222430962427
19,0,2,0,0,2,0.0007648100176554784,0.0005230866089939765
19,1,1,0,6,7,1.6178874115591766,1.1065430895385577
19,2,1,1,5,7,0.6145146697361973,0.4202931281610918
19,3,1,1,4,6,0.561437242137983,0.3839911826118116
19,4,1,1,5,7,0.5131958577276041,0.3509968159039121
19,5,1,0,9,10,0.5538212084144825,0.3787822481543079
19,6,1,0,8,9,1.1263157351592537,0.7703359853563126
19,7,1,1,7,9,0.60468814295434,0.41357234201309234
19,8,1,0,3,4,5.35060242225039,3.659508129495622
19,9,1,0,2,3,9.15733163143198,6.263094677032336
19,10,1,0,1,2,8.576338038480174,5.865728061312499
19,11,1,0,1,2,0.11376174863366881,0.07780657411945277
19,12,1,0,2,3,0.0013744269987290432,0.0009400299963105406
19,13,1,0,0,1,0.004197321260139596,0.0028707293238067577
19,14,0,1,19,20,0.23542870657310422,0.1610198623687979
19,15,1,1,1,3,0.45293728619282964,0.30978337580859017
19,16,1,2,5,8,1.5146735988691133,1.0359507044559328
19,17,1,2,5,8,1.1818181818181819,0.8082965061960985
19,18,1,0,7,8,0.39098334217228375,0.2674103972343106
19,20,0,0,19,19,0.009102981331913782,0.00622592215939203
19,21,0,0,20,20,0.6273161801862513,0.42904863415177846
19,22,0,1,23,24,1.1353697112331265,0.7765283907028233
19,23,0,1,24,25,1.9697441719285906,1.3471931273053905
19,24,0,1,21,22,1.1160739645495608,0.7633311960169401
19,25,0,1,22,23,0.9175836408607203,0.6275750893503518
19,26,0,2,19,21,0.8755731808716667,0.5988423210148693
19,27,0,1,27,28,1.1681547429481347,0.798951490125782
19,28,0,1,26,27,1.0494552571718125,0.7177677842763189
19,29,0,0,2,2,0.3493692817831421,0.2389487437086995
19,30,0,1,20,21,3.0771837407396667,2.104618887092035
19,31,0,1,8,9,0.1732642045142017,0.11850287405649466
19,32,1,1,3,5,0.6758625033664689,0.46225156165697867
19,33,0,0,4,4,0.8319205711693238,0.568986415553623
19,34,0,2,6,8,0.034485302827597604,0.02358598828440595
19,35,1,0,3,4,0.5128866054522421,0.35078530491385124
19,36,0,0,1,1,0.34513409946811735,0.23605211957395197
19,37,0,1,2,3,0.25752463689056854,0.17613222360297845
19,38,0,1,31,32,1.854230544175284,1.2681883673791305
19,39,0,1,29,30,0.7489872277175029,0.512264719449627
19,40,0,1,9,10,0.39607634768636973,0.2708937237107571
19,41,1,0,4,5,1.3416154250496446,0.9175887436915873
19,42,1,1,6,8,0.1474171781611953,0.10082497620544625
19,43,0,1,25,26,0.7390540216360999,0.5054709707203838
19,44,0,0,3,3,0.6801423731681719,0.4651787494942555
19,45,0,0,6,6,1.3542984401011189,0.9262632055604744
19,46,0,0,7,7,0.6191452889983811,0.4234602087059089
19,47,0,0,11,11,2.5256469108416897,1.7273990240847212
19,48,0,2,20,22,0.8948253753203369,0.6120097284459576
19,49,0,1,28,29,2.3102050112225,1.580049002372809
19,50,0,0,9,9,1.989398302806265,1.3606354364229438
19,51,1,1,2,4,0.6682598151584125,0.4570517547739807
19,52,0,1,30,31,1.9231775789042467,1.3153442227732859
19,53,0,1,1,2,0.1495192142166634,0.10226264946658967
19,54,0,2,7,9,0.09762518158227176,0.0667700788528315
19,55,0,1,7,8,0.30398523778859465,0.20790863554129416
19,56,0,0,5,5,1.290351656119255,0.8825272376508444
19,57,1,0,5,6,3.585919686774928,2.4525653767322932
19,58,0,1,0,1,0.3654262993250074,0.2499308316294081
19,59,1,2,7,10,1.0536236644334789,0.7206187380675558
19,60,0,1,6,7,0.024509803921568627,0.01676331366545453
19,61,0,0,8,8,1.2852786301551369,0.8790575760516887
19,62,0,1,7,8,0.823514440102814,0.5632370993929653
19,63,1,2,8,11,1.2334401957749261,0.8436030314856732
19,64,0,0,18,18,1.6748896980511152,1.1455294156295464
19,65,0,0,17,17,1.3095932516866762,0.8956873960492008
19,66,0,0,16,16,1.2963081961529308,0.8866011726878146
19,67,0,0,15,15,0.9318883154753747,0.6373586742462187
19,68,0,0,14,14,0.7987516667447718,0.5463007690022466
19,69,0,0,13,13,0.5516329105344367,0.3772855767050364
19,70,0,1,5,6,0.33888898327430755,0.23178081483528304
19,71,0,1,4,5,0.15519413656936337,0.10614397400634633
19,72,0,1,3,4,0.28266618759786444,0.19332761618510558
19,73,0,0,12,12,2.5279077319161227,1.7289452972794588
19,74,0,0,10,10,2.3494297675777864,1.606876507657585
19,75,1,0,4,5,0.017238788079954947,0.011790351841300607
19,76,1,0,5,6,0.3741087410467056,0.25586912858309263
19,77,1,1,8,10,1.8033590405378253,1.233395148517123
19,78,1,1,4,6,3.6708060937526468,2.510622857349211
20,0,2,0,0,2,0.0004863038957687186,0.00033260424145334437
20,1,1,0,6,7,0.5244647436483397,0.3587040937733723
20,2,1,1,5,7,3.1699791550362275,2.168085679464052
20,3,1,1,4,6,3.2942090993818156,2.2530519048313
20,4,1,1,5,7,3.3696643247305698,2.3046589929282235
20,5,1,0,9,10,0.22007847821617676,0.15052117810322987
20,6,1,0,8,9,0.27396133908738945,0.1873739942606582
20,7,1,1,7,9,0.15951832915689165,0.10910147611148478
20,8,1,0,3,4,1.9293513661888746,1.319566742589731
20,9,1,0,2,3,3.894465248002765,2.663593014468487
20,10,1,0,1,2,3.886953270986637,2.65845524888815
20,11,1,0,1,2,0.06457308163428618,0.044164319928646056
20,12,1,0,2,3,0.000987666360725212,0.0006755076888675114
20,13,1,0,0,1,0.001008072607015824,0.0006894644022055164
20,14,0,1,0,1,0.007265806914127203,0.004969399213633017
20,15,1,1,1,3,0.29734646106786766,0.203368089363096
20,16,1,2,5,8,7.617177225776547,5.2097165481068
20,17,1,2,5,8,7.4229541244631365,5.076878979156323
20,18,1,0,7,8,0.10193136830571403,0.06971526596971232
20,19,0,0,19,19,0.023696276934430677,0.01620690741657774
20,21,0,0,1,1,0.28303606635850115,0.1935805922473615
20,22,0,1,4,5,0.3576855963241652,0.24463663046772297
20,23,0,1,5,6,0.8017571382429967,0.5483563407888894
20,24,0,1,2,3,0.16779680848473233,0.11476348573382425
20,25,0,1,3,4,0.22056298916322256,0.1508525560696006
20,26,0,2,0,2,0.035451235852319594,0.02424663160595398
20,27,0,1,8,9,0.3647038491289123,0.24943671673221976
20,28,0,1,7,8,0.24601202897984026,0.16825825373636924
20,29,0,0,17,17,0.41340759064780463,0.28274730943932624
20,30,0,1,1,2,1.2373972637268345,0.8463094411936259
20,31,0,1,27,28,1.0454649400620943,0.7150386340330577
20,32,1,1,3,5,1.181048077532045,0.8077697986081908
20,33,0,0,15,15,0.30605455029308426,0.20932392775234612
20,34,0,2,25,27,1.622665256521573,1.1098108640995397
20,35,1,0,3,4,0.6354853000942571,0.4346358481428338
20,36,0,0,18,18,0.7427768166739749,0.5080171510624132
20,37,0,1,21,22,1.0260219899345944,0.7017407605530394
20,38,0,1,12,13,0.7476374247275327,0.5113415308766036
20,39,0,1,10,11,0.34089796091071944,0.23315484142373813
20,40,0,1,28,29,1.5262203017687666,1.0438479933582878
20,41,1,0,4,5,1.6024425726513274,1.0959796970302702
20,42,1,1,6,8,1.5043352988473098,1.0288798944817834
20,43,0,1,6,7,0.10903113722518457,0.07457110462636497
20,44,0,0,16,16,0.44647837981803545,0.30536585072993383
20,45,0,0,13,13,0.17891728442212157,0.12236925960472611
20,46,0,0,12,12,0.1205063391601362,0.08241949093029399
20,47,0,0,8,8,1.1079120614031013,0.7577489178808526
20,48,0,2,1,3,0.02781326359285691,0.01902269243601471
20,49,0,1,9,10,0.9328968625322142,0.6380484631451537
20,50,0,0,10,10,0.5533998868834101,0.37849408815914937
20,51,1,1,2,4,1.4014516903117915,0.9585133502844626
20,52,0,1,11,12,0.39339547531714186,0.26906015929032245
20,53,0,1,20,21,1.2207384023353465,0.8349157262659804
20,54,0,2,26,28,1.3693168720392745,0.9365349599224517
20,55,0,1,26,27,2.0500314954242547,1.4021050960597898
20,56,0,0,14,14,0.2708809319423219,0.18526717074810317
20,57,1,0,5,6,2.5684065098811755,1.7566441609777665
20,58,0,1,19,20,2.2205747088710655,1.5187469667851468
20,59,1,2,7,10,0.2551528255255141,0.17451003935397638
20,60,0,1,25,26,0.7371675480164057,0.5041807299208353
20,61,0,0,11,11,0.31687681182511973,0.21672573990929472
20,62,0,1,12,13,0.14731761381057928,0.10075687984512392
20,63,1,2,8,11,0.35116626228066433,0.2401777762961109
20,64,0,0,1,1,0.15740960010949984,0.10765922522404392
20,65,0,0,2,2,0.23835328060874916,0.1630201048862102
20,66,0,0,3,3,0.45391600557239214,0.31045276427055285
20,67,0,0,4,4,0.5927501089416944,0.4054074048580163
20,68,0,0,5,5,0.9405377018951577,0.6432743632510154
20,69,0,0,6,6,1.1880222569345824,0.8125397411690533
20,70,0,1,24,25,1.4053019054537492,0.9611466787399109
20,71,0,1,23,24,1.6096412252559165,1.1009031665107085
20,72,0,1,22,23,1.8781108452970026,1.2845211368867888
20,73,0,0,7,7,1.1179282009012215,0.7645993883563094
20,74,0,0,9,9,0.649400141427629,0.4441528092177887
20,75,1,0,4,5,0.1639702181126459,0.1121463152790233
20,76,1,0,5,6,2.0294598174955527,1.3880352368782536
20,77,1,1,8,10,0.5085501823827647,0.3478194378537809
20,78,1,1,4,6,5.7699472637429245,3.9463161812623535
21,0,2,0,0,2,0.0008725521732875535,0.0005967761234279666
21,1,1,0,6,7,0.4931063540519587,0.3372567365227877
21,2,1,1,5,7,5.356075823334528,3.6632516249345852
21,3,1,1,4,6,5.677413696885501,3.8830284776651296
21,4,1,1,5,7,5.9673456286286015,4.081325450133512
21,5,1,0,9,10,0.7737071920335743,0.5291717708872963
21,6,1,0,8,9,1.1954810429705156,0.8176411271403148
21,7,1,1,7,9,0.26682777502414223,0.18249504164530925
21,8,1,0,3,4,1.246524092847622,0.8525516738859948
21,9,1,0,2,3,1.1925251052045864,0.8156194336129249
21,10,1,0,1,2,0.9043999881222192,0.6185582197409853
21,11,1,0,1,2,0.04408339868992204,0.03015054065888078
21,12,1,0,2,3,0.0015698484399307906,0.0010736871616759992
21,13,1,0,0,1,0.0052708260043790095,0.003604945591167542
21,14,0,1,1,2,0.1827926182814447,0.12501976783604746
21,15,1,1,1,3,0.24301134741577238,0.16620595799260968
21,16,1,2,5,8,12.860083052263352,8.795566323530569
21,17,1,2,5,8,13.133673835974152,8.982686878962092
21,18,1,0,7,8,0.17188195478921195,0.11755749375977183
21,19,0,0,20,20,0.0431701457332474,0.02952592751152024
21,20,0,0,1,1,0.007482424451718862,0.005117553304938981
21,22,0,1,5,6,0.28534593714743206,0.1951604126606715
21,23,0,1,6,7,0.16049882068628923,0.10977207662327221
21,24,0,1,3,4,0.6195538512079181,0.423739642049898
21,25,0,1,4,5,0.3559771084540848,0.24346812181088387
21,26,0,2,1,3,0.6862611172051454,0.4693636228558964
21,27,0,1,9,10,0.29595068095132937,0.20241345504711333
21,28,0,1,8,9,0.41466707696925037,0.283608726541287
21,29,0,0,18,18,1.020584908784465,0.6980221058858781
21,30,0,1,2,3,0.30787902912907095,0.21057176764129415
21,31,0,1,28,29,1.7833775084871948,1.219728915594456
21,32,1,1,3,5,2.3386795543231007,1.5995239724298247
21,33,0,0,16,16,1.1890357952765676,0.8132329438235106
21,34,0,2,26,28,2.9427317476944594,2.0126613610516517
21,35,1,0,3,4,0.8357915037095854,0.5716339135327121
21,36,0,0,19,19,1.6100096043472396,1.1011551168843388
21,37,0,1,22,23,2.0429729057049015,1.3972774216369381
21,38,0,1,13,14,0.1876251949144354,0.1283249757508232
21,39,0,1,11,12,1.2138801487099535,0.8302250703518166
21,40,0,1,29,30,3.0540514905825815,2.088797741953059
21,41,1,0,4,5,2.1083477691075267,1.44199011475196
21,42,1,1,6,8,2.674190132907721,1.828994150359023
21,43,0,1,7,8,0.4093952536445604,0.28000309883967706
21,44,0,0,17,17,1.3359317340732317,0.9137014219112902
21,45,0,0,14,14,1.2100269512049315,0.8275897021294379
21,46,0,0,13,13,0.32542416764722454,0.2225716457808673
21,47,0,0,9,9,0.19142272900493876,0.13092227335948922
21,48,0,2,2,4,0.6881220393179172,0.4706363878760981
21,49,0,1,10,11,0.20316375219039848,0.13895246629946767
21,50,0,0,11,11,0.6991817868254767,0.47820062695051996
21,51,1,1,2,4,2.668062785576415,1.824803392832747
21,52,0,1,12,13,0.9020177381847875,0.6169288961014139
21,53,0,1,21,22,2.2833856574506655,1.5617060877978615
21,54,0,2,27,29,2.5692437969209014,1.757216817752984
21,55,0,1,27,28,3.4909209280102336,2.387591621899434
21,56,0,0,15,15,1.4311879040042395,0.9788512313603219
21,57,1,0,5,6,2.2732047861994307,1.5547429501604413
21,58,0,1,20,21,3.7696054527134883,2.5781960068328327
21,59,1,2,7,10,0.5208275622948971,0.35621646832842757
21,60,0,1,26,27,1.3583541191862827,0.9290370596822201
21,61,0,0,12,12,0.5330327678707301,0.36456413565672446
21,62,0,1,13,14,0.46446361136368014,0.317666727501949
21,63,1,2,8,11,0.4793230297966332,0.3278297256587245
21,64,0,0,2,2,1.4721316368186808,1.006854418901086
21,65,0,0,3,3,1.4436223225470886,0.9873556673381998
21,66,0,0,4,4,1.8499872879458454,1.2652862211455422
21,67,0,0,5,5,1.821255288309498,1.2456351654422375
21,68,0,0,6,6,2.348659823295239,1.6063499095030436
21,69,0,0,7,7,2.5981874384965424,1.7770126245209852
21,70,0,1,25,26,2.8165928269917226,1.9263895042906476
21,71,0,1,24,25,3.021671828269096,2.0666518921747667
21,72,0,1,23,24,3.1968904433753194,2.186491472060895
21,73,0,0,8,8,0.15771373219707094,0.10786723429649502
21,74,0,0,10,10,0.8101048881761785,0.5540657275705422
21,75,1,0,4,5,0.2907240825214846,0.19883875860469263
21,76,1,0,5,6,3.436380847502446,2.3502893048422746
21,77,1,1,8,10,0.685286841808272,0.46869727382566406
21,78,1,1,4,6,11.666427745123181,7.979173895991942
22,0,3,0,0,3,0.0006826024199211588,0.0004668612817366171
22,1,2,0,6,8,0.17175096118458674,0.11746790157496577
22,2,2,1,5,8,4.375267297830972,2.9924343058168477
22,3,2,1,4,7,4.607401432135162,3.151200867893482
22,4,2,1,5,8,4.800031020094198,3.2829485642250296
22,5,2,0,9,11,0.5127479170516187,0.35069044992566567
22,6,2,0,8,10,0.7402615202758275,0.5062968312010769
22,7,2,1,7,10,0.10821194725171221,0.07401082521650695
22,8,2,0,3,5,0.5604934366805587,0.38334567328939523
22,9,2,0,2,4,1.5399922087745832,1.0532671954722148
22,10,2,0,1,3,1.7574281135085674,1.2019810034182716
22,11,2,0,1,3,0.05077655988049165,0.034728282725280175
22,12,2,0,2,4,0.0012838254085765597,0.0008780636550384869
22,13,2,0,0,2,0.003375615967711954,0.002308729578659591
22,14,0,0,4,4,0.09919469177540315,0.06784353467290997
22,15,2,1,1,4,0.26209029492956326,0.17925487436109086
22,16,2,2,5,9,10.50603331953174,7.185530022133103
22,17,2,2,5,9,10.565560769791885,7.226243416806057
22,18,2,0,7,9,0.06848725175126659,0.04684138995421044
22,19,1,0,19,20,0.034531982000638874,0.02361791418727481
22,20,1,0,0,1,0.004179161832140437,0.0028583093065553244
22,21,1,0,1,2,0.12611271329283827,0.08625393238127892
22,23,0,0,1,1,0.26763340605524366,0.1830460475087667
22,24,0,0,2,2,0.2716049382716049,0.18576234995199986
22,25,0,0,1,1,0.10054755834520769,0.0687688185605213
22,26,0,1,4,5,0.3733349867688254,0.25533992460816085
22,27,0,0,4,4,0.03866814831931372,0.02644681700487015
22,28,0,0,3,3,0.12782400281028775,0.08742435720577803
22,29,1,0,17,18,0.7474114072446935,0.5111869477566882
22,30,0,0,3,3,0.390502151248626,0.26708128997535174
22,31,1,1,27,29,1.4581570129700103,0.9972965699814602
22,32,2,1,3,6,1.8321709282916114,1.2531008431549149
22,33,1,0,15,16,0.7855077650663881,0.5372426925402877
22,34,1,2,25,28,2.35632460094105,1.6115921820346335
22,35,2,0,3,5,0.7493555505573595,0.5125166313504494
22,36,1,0,18,19,1.2210198030373092,0.8351081883618737
22,37,1,1,21,23,1.587553206069635,1.0857962160408852
22,38,0,0,8,8,0.2667349360194034,0.18243154503955075
22,39,0,0,6,6,0.8298829030146658,0.5675927662803794
22,40,1,1,28,30,2.381485722563449,1.6288009600110154
22,41,2,0,4,6,1.8889775362731507,1.291953336259809
22,42,2,1,6,9,2.151517950763,1.4715160668322418
22,43,0,0,2,2,0.18254091384646837,0.12484761629995211
22,44,1,0,16,17,0.9335213346722683,0.6384755666174036
22,45,1,0,13,14,0.6990242283895862,0.47809286593007594
22,46,1,0,12,13,0.1389308381093909,0.09502080165491389
22,47,1,0,8,9,0.4568822896674776,0.3124815340993889
22,48,0,1,5,6,0.37395018487466325,0.2557606851677946
22,49,0,0,5,5,0.3142146835317197,0.21490499537201693
22,50,1,0,10,11,0.1894034088541785,0.12954117307870003
22,51,2,1,2,5,2.114608989992135,1.4462724341843491
22,52,0,0,7,7,0.37670678252455186,0.2576460413788197
22,53,1,1,20,22,1.8081309675841852,1.2366588755596883
22,54,1,2,26,29,2.0360729367836172,1.3925582348299155
22,55,1,1,26,28,2.853258612664439,1.9514668189843478
22,56,1,0,14,15,0.8882408983440947,0.6075063202086287
22,57,2,0,5,7,2.38055539738104,1.6281646704309964
22,58,1,1,19,21,3.077913227594519,2.1051178146641134
22,59,2,2,7,11,0.22718811381357903,0.15538376500713638
22,60,1,1,25,27,1.0823889060520882,0.7402925293985014
22,61,1,0,11,12,0.17949175818335725,0.12276216702589456
22,62,1,1,12,14,0.20967704406996338,0.14340718797415727
22,63,2,2,8,12,0.17757659393067018,0.12145230346307725
22,64,1,0,1,2,0.8415681824663975,0.5755848336728684
22,65,1,0,2,3,0.8919304098173979,0.610029736483079
22,66,1,0,3,4,1.219628640630384,0.8341567122969692
22,67,1,0,4,5,1.2698647398520564,0.8685153506311063
22,68,1,0,5,6,1.7187239098205318,1.1755095265892288
22,69,1,0,6,7,1.9684437525009966,1.346303714283925
22,70,1,1,24,26,2.187001127516903,1.4957845442005575
22,71,1,1,23,25,2.3922094839130352,1.63613540363822
22,72,1,1,22,24,2.6095985017388745,1.7848171436023972
22,73,1,0,7,8,0.46902385310742684,0.3207856738217706
22,74,1,0,9,10,0.198773543400832,0.13594981286201707
22,75,2,0,4,6,0.2340632098375112,0.16008594016521158
22,76,2,0,5,7,2.8059465172701725,1.9191080331775772
22,77,2,1,8,11,0.238612667340676,0.1631975106770464
22,78,2,1,4,7,9.083850497959611,6.212837755645606
23,0,3,0,0,3,0.0007982035502906098,0.0005459258884819569
23,1,2,0,6,8,0.3487386094115954,0.23851739963029714
23,2,2,1,5,8,4.988587718653199,3.411910635557047
23,3,2,1,4,7,5.2764621263841365,3.608800378473513
23,4,2,1,5,8,5.529884473798632,3.7821268690949488
23,5,2,0,9,11,0.6755546357640461,0.46204099770455537
23,6,2,0,8,10,1.023950515629747,0.7003239897933383
23,7,2,1,7,10,0.20444015246822353,0.1398254515868377
23,8,2,0,3,5,0.8292434070278604,0.5671553873503428
23,9,2,0,2,4,0.9141906796535567,0.6252544966131596
23,10,2,0,1,3,0.9606056934443504,0.6569997295595875
23,11,2,0,1,3,0.04582003583176822,0.0313383018186601
23,12,2,0,2,4,0.0014571197168508178,0.0009965871183568928
23,13,2,0,0,2,0.004561537042232907,0.003119832230410029
23,14,0,0,5,5,0.15148838759444144,0.10360945220311858
23,15,2,1,1,4,0.248444839213005,0.16992215774627367
23,16,2,2,5,9,11.977948488785549,8.192236389515704
23,17,2,2,5,9,12.171124886046298,8.324358072349517
23,18,2,0,7,9,0.13137489023374768,0.08985296250432126
23,19,1,0,19,20,0.039939513163529027,0.02731635834167612
23,20,1,0,0,1,0.006245098796681039,0.00427129284002109
23,21,1,0,1,2,0.04728983109506736,0.03234355829078556
23,22,0,0,1,1,0.17842227070349578,0.1220306983391778
23,24,0,0,3,3,0.48923949268955486,0.3346120229981006
23,25,0,0,2,2,0.26027288091017486,0.17801186640539715
23,26,0,1,5,6,0.5691015227618677,0.38923311520863596
23,27,0,0,3,3,0.18786134163407742,0.12848648669334622
23,28,0,0,2,2,0.3060674767877538,0.20933276874044351
23,29,1,0,17,18,0.9182412246453996,0.6280248393067028
23,30,0,0,4,4,0.09018218576541037,0.061679492494492005
23,31,1,1,27,29,1.6618530418585615,1.136613083307844
23,32,2,1,3,6,2.1489036117127256,1.469728007422716
23,33,1,0,15,16,1.0377408744233694,0.7097558118820178
23,34,1,2,25,28,2.7233756945399787,1.862634280655109
23,35,2,0,3,5,0.8032185563381375,0.5493558677538384
23,36,1,0,18,19,1.464311717088388,1.001506037996161
23,37,1,1,21,23,1.8724187921494992,1.2806280958564575
23,38,0,0,7,7,0.10487521603962445,0.07172869060194495
23,39,0,0,5,5,1.0700917954163016,0.7318820042296288
23,40,1,1,28,30,2.8026537885194474,1.9168559937471392
23,41,2,0,4,6,2.025383927029391,1.3852475593199614
23,42,2,1,6,9,2.4785056783887365,1.695157098824375
23,43,0,0,1,1,0.324123044212089,0.22168175125823275
23,44,1,0,16,17,1.185117553680679,0.8105530891376431
23,45,1,0,13,14,1.0181417295202393,0.6963511100477143
23,46,1,0,12,13,0.2549736369814643,0.17438748456819456
23,47,1,0,8,9,0.1874308285759999,0.12819204021581743
23,48,0,1,6,7,0.5703581475920483,0.39009257521311114
23,49,0,0,4,4,0.06198769627753494,0.04239606320084925
23,50,1,0,10,11,0.500745541504871,0.3424815068160206
23,51,2,1,2,5,2.460871747357925,1.6830964916497757
23,52,0,0,6,6,0.6998285504321755,0.4786429765197449
23,53,1,1,20,22,2.105430712673487,1.4399950138470274
23,54,1,2,26,29,2.3697912409559754,1.6208025988667034
23,55,1,1,26,28,3.2525300069762606,2.2245457731004397
23,56,1,0,14,15,1.227479075852947,0.8395259640652524
23,57,2,0,5,7,2.3040173610457018,1.5758170011255654
23,58,1,1,19,21,3.5106596065043463,2.4010917567841203
23,59,2,2,7,11,0.4070818749259145,0.27842087920170094
23,60,1,1,25,27,1.2551225296353772,0.8584325162365484
23,61,1,0,11,12,0.3980557614425647,0.27224753028444465
23,62,1,1,12,14,0.3683445207280993,0.2519267293069992
23,63,2,2,8,12,0.3578188047771584,0.24472773748300392
23,64,1,0,1,2,1.23580306826499,0.8452191020519316
23,65,1,0,2,3,1.2369265682347832,0.8459875122137199
23,66,1,0,3,4,1.6138825078187593,1.1038039628684544
23,67,1,0,4,5,1.6147761404115986,1.1044151568014364
23,68,1,0,5,6,2.1128160708029857,1.4450461793011724
23,69,1,0,6,7,2.3624519569810025,1.6157829455171293
23,70,1,1,24,26,2.5809411798883306,1.765217163262701
23,71,1,1,23,25,2.7860907555251964,1.9055278199999162
23,72,1,1,22,24,2.977126340953639,2.0361853091437854
23,73,1,0,7,8,0.18227287141530207,0.12466429050250102
23,74,1,0,9,10,0.5749967072332517,0.3932650865261447
23,75,2,0,4,6,0.26950886974695343,0.18432875814296462
23,76,2,0,5,7,3.2002242340620533,2.1887715955231446
23,77,2,1,8,11,0.5067928093232876,0.346617494504193
23,78,2,1,4,7,10.698234897008593,7.316984983606883
24,0,3,0,0,3,0.0005591142851509227,0.0003824024119823092
24,1,2,0,6,8,0.33223181597984114,0.22722769054927677
24,2,2,1,5,8,3.6151052963935015,2.4725266758972824
24,3,2,1,4,7,3.77854342056348,2.5843090691437594
24,4,2,1,5,8,3.896350212241712,2.664882222937341
24,5,2,0,9,11,0.31638501301074934,0.21638937745564266
24,6,2,0,8,10,0.40518452888234313,0.2771232022818009
24,7,2,1,7,10,0.08849315029548596,0.060524288174415616
24,8,2,0,3,5,1.3196308649901725,0.90255255338777
24,9,2,0,2,4,2.9523037797666913,2.0192080872741904
24,10,2,0,1,3,3.048257902208784,2.0848352565953916
24,11,2,0,1,3,0.05938575336275022,0.040616482043867405
24,12,2,0,2,4,0.0011002195406250698,0.0007524876706227018
24,13,2,0,0,2,0.0018936053146302266,0.0012951184737869028
24,14,0,0,2,2,0.03388808152080902,0.023177522834195656
24,15,2,1,1,4,0.2849333026076555,0.1948781940741169
24,16,2,2,5,9,8.682777493406128,5.938526602460093
24,17,2,2,5,9,8.57873596422,5.867368106310483
24,18,2,0,7,9,0.05537610386856111,0.03787410954775478
24,19,1,0,19,20,0.02777326916390612,0.018995338518393898
24,20,1,0,0,1,0.001604062395230057,0.0010970875636642312
24,21,1,0,1,2,0.22403509798143464,0.15322728127697202
24,22,0,0,2,2,0.2222222222222222,0.15198737723345443
24,23,0,0,3,3,0.6004302864826355,0.4106602100431235
24,25,0,0,1,1,0.09873603900311995,0.06752984222926917
24,26,0,1,2,3,0.12889367807194263,0.08815595432457499
24,27,0,0,6,6,0.22930393616091482,0.1568308673088221
24,28,0,0,5,5,0.11400421836737253,0.07797240964443132
24,29,1,0,17,18,0.535730992000603,0.36640956769581784
24,30,0,0,1,1,0.915127277298281,0.6258950762011105
24,31,1,1,27,29,1.202517088504463,0.8224533826209139
24,32,2,1,3,6,1.4358975568844723,0.9820723664105813
24,33,1,0,15,16,0.47488129558654885,0.32479183176040965
24,34,1,2,25,28,1.898009282409101,1.2981305375914958
24,35,2,0,3,5,0.6821884481530561,0.4665781485618454
24,36,1,0,18,19,0.9191075185384527,0.6286173351219361
24,37,1,1,21,23,1.233773978899444,0.8438313201831441
24,38,0,0,10,10,0.5657071012244261,0.3869115236884838
24,39,0,0,8,8,0.5295747915795683,0.36219907629509335
24,40,1,1,28,30,1.8528128851276158,1.267218769117032
24,41,2,0,4,6,1.720280447805389,1.176574110155701
24,42,2,1,6,9,1.7448975192078537,1.1934107886850327
24,43,0,0,4,4,0.031862745098039214,0.021792307765090894
24,44,1,0,16,17,0.622525050756586,0.42577177376977465
24,45,1,0,13,14,0.31424241188253205,0.2149239599889343
24,46,1,0,12,13,0.045748102571460704,0.03128910355459513
24,47,1,0,8,9,0.8566471311282338,0.585897978036345
24,48,0,1,3,4,0.13069371729211596,0.08938707890453673
24,49,0,0,7,7,0.7001320939505572,0.47885058304430256
24,50,1,0,10,11,0.29922444326491654,0.20465252251188862
24,51,2,1,2,5,1.6803216664608527,1.1492445734726957
24,52,0,0,9,9,0.20820182516010757,0.14239822203586347
24,53,1,1,20,22,1.4386405967636475,0.9839484498765533
24,54,1,2,26,29,1.6194289347204263,1.1075974038185608
24,55,1,1,26,28,2.3534680757280464,1.609638481046568
24,56,1,0,14,15,0.47363163225963173,0.3239371330287364
24,57,2,0,5,7,2.5080039872376596,1.715332266500841
24,58,1,1,19,21,2.5396284867725445,1.736961627833666
24,59,2,2,7,11,0.1390859251791805,0.09512687240132456
24,60,1,1,25,27,0.866711581659315,0.5927814905141621
24,61,1,0,11,12,0.14863503435774247,0.10165792066666951
24,62,1,1,12,14,0.060006886657124545,0.041041301935326895
24,63,2,2,8,12,0.2022058065650361,0.13829728590537774
24,64,1,0,1,2,0.35676598418920186,0.24400766800362986
24,65,1,0,2,3,0.46526208854274415,0.3182128405369692
24,66,1,0,3,4,0.7306509734651082,0.49972376308514443
24,67,1,0,4,5,0.8413458587310609,0.5754327768664309
24,68,1,0,5,6,1.228534604151197,0.8402478854646628
24,69,1,0,6,7,1.4780123436164712,1.010876488312224
24,70,1,1,24,26,1.6964315084561044,1.1602627903189624
24,71,1,1,23,25,1.9015472897158017,1.3005503336217978
24,72,1,1,22,24,2.1515346993483515,1.4715275219132617
24,73,1,0,7,8,0.8690421392749837,0.5943754595418983
24,74,1,0,9,10,0.3473116735684806,0.2375414565670577
24,75,2,0,4,6,0.1900023647281544,0.1299508248743388
24,76,2,0,5,7,2.3167986969455003,1.5845587088698412
24,77,2,1,8,11,0.2865898267225552,0.19601116247408099
24,78,2,1,4,7,7.0676687500857085,4.833883964161683
25,0,3,0,0,3,0.0006138720348721052,0.00041985360241728726
25,1,2,0,6,8,0.21198830409356725,0.14498795854507165
25,2,2,1,5,8,3.991895966892653,2.7302300918856854
25,3,2,1,4,7,4.189375102703009,2.865294603481338
25,4,2,1,5,8,4.344250860454091,2.971220824460677
25,5,2,0,9,11,0.4129859294843156,0.2824589171548867
25,6,2,0,8,10,0.5683881814484313,0.38874523026977936
25,7,2,1,7,10,0.07345594558121546,0.050239694299915316
25,8,2,0,3,5,0.8882730017398,0.6075282771077395
25,9,2,0,2,4,2.2361650269552507,1.5294098587864746
25,10,2,0,1,3,2.4013059750085888,1.642356886844603
25,11,2,0,1,3,0.05462372001051871,0.037359521726099854
25,12,2,0,2,4,0.0011808933730210651,0.0008076639895102755
25,13,2,0,0,2,0.002627752512767994,0.0017972334559540207
25,14,0,0,3,3,0.06618461454860824,0.04526651690302544
25,15,2,1,1,4,0.2720052887272929,0.1860361669228039
25,16,2,2,5,9,9.586510342953558,6.556628537311028
25,17,2,2,5,9,9.563472172804184,6.540871737553351
25,18,2,0,7,9,0.04522233510627726,0.03092950847328953
25,19,1,0,19,20,0.0311217308605295,0.021285496118058016
25,20,1,0,0,1,0.0028737848750908478,0.0019655056165420273
25,21,1,0,1,2,0.17544586059522752,0.11999500289250706
25,22,0,0,1,1,0.11212576203344372,0.07668765221294498
25,23,0,0,2,2,0.43536554624974705,0.2977653038053916
25,24,0,0,1,1,0.13457356427091904,0.09204067385322615
25,26,0,1,3,4,0.25,0.17098579938763622
25,27,0,0,5,5,0.11858541225631422,0.08110568604143312
25,28,0,0,4,4,0.03801726581436386,0.026001650343205042
25,29,1,0,17,18,0.6406162106669909,0.4381450995262952
25,30,0,0,2,2,0.6550394761208403,0.44800979381992134
25,31,1,1,27,29,1.3290485294535792,0.9089937009343305
25,32,2,1,3,6,1.6300081733642366,1.114833002124259
25,33,1,0,15,16,0.6285405836587822,0.4298860565778732
25,34,1,2,25,28,2.12510212172916,1.453449140256889
25,35,2,0,3,5,0.7143131974882438,0.48854965234266334
25,36,1,0,18,19,1.0687302881508625,0.730950810597016
25,37,1,1,21,23,1.4091135286145164,0.9637536124723434
25,38,0,0,9,9,0.41398512865630777,0.28314231263156886
25,39,0,0,7,7,0.6775286996791272,0.46339114529080505
25,40,1,1,28,30,2.114333869283275,1.4460842672470189
25,41,2,0,4,6,1.8004736173889302,1.2314216829823814
25,42,2,1,6,9,1.9464337266910858,1.3312501068533245
25,43,0,0,3,3,0.09430879395927447,0.06450185809764171
25,44,1,0,16,17,0.7765427511278342,0.5311111322410679
25,45,1,0,13,14,0.5026480236773884,0.34378269655637494
25,46,1,0,12,13,0.07280109889280517,0.04979181636193861
25,47,1,0,8,9,0.6577516052517457,0.4498647360898827
25,48,0,1,4,5,0.24993150997542812,0.17093895610123022
25,49,0,0,6,6,0.5072937401304201,0.34696010272217465
25,50,1,0,10,11,0.1414888083001497,0.09677030796642046
25,51,2,1,2,5,1.8934142074863365,1.2949877673558357
25,52,0,0,8,8,0.20754758490524525,0.14195075886398667
25,53,1,1,20,22,1.6217723175621077,1.1092001445723858
25,54,1,2,26,29,1.8258764342676528,1.2487957667852057
25,55,1,1,26,28,2.6010169657651883,1.7789478604486588
25,56,1,0,14,15,0.678113027530447,0.4637907923498547
25,57,2,0,5,7,2.4338619517137783,1.6646233256517313
25,58,1,1,19,21,2.8064239228108754,1.9194345514496136
25,59,2,2,7,11,0.14515158546818344,0.09927543949464059
25,60,1,1,25,27,0.9735787756771704,0.6658725809039886
25,61,1,0,11,12,0.08624117978893404,0.05898406826537498
25,62,1,1,12,14,0.11708935628558174,0.08008246873709578
25,63,2,2,8,12,0.13940267779337567,0.0953435131971097
25,64,1,0,1,2,0.5960114024385227,0.40763794436038786
25,65,1,0,2,3,0.6764019006847926,0.4626204787836231
25,66,1,0,3,4,0.9728558481478693,0.6653781395380011
25,67,1,0,4,5,1.0536815225563,0.7206583097370824
25,68,1,0,5,6,1.4714613488894333,1.006395980031477
25,69,1,0,6,7,1.721067546982253,1.1771124412835148
25,70,1,1,24,26,1.9395561834542225,1.3265462579406124
25,71,1,1,23,25,2.144716455261485,1.46686423025081
25,72,1,1,22,24,2.378543591792161,1.6267887096836888
25,73,1,0,7,8,0.6704520670895914,0.45855113056962765
25,74,1,0,9,10,0.1437610909652198,0.09832442023810718
25,75,2,0,4,6,0.2118408114881191,0.14488708198088637
25,76,2,0,5,7,2.55925472699633,1.750384861328217
25,77,2,1,8,11,0.1838639207621351,0.1257524778802347
25,78,2,1,4,7,8.054039417704969,5.508505472543266
26,0,4,0,0,4,0.0005154182221443153,0.00035251678692920017
26,1,3,0,6,9,0.48664669523664444,0.3328386968175562
26,2,3,1,5,9,3.2154296370425532,2.199171227457672
26,3,3,1,4,8,3.3428969211640385,2.2863516093428045
26,4,3,1,5,9,3.4215899094378504,2.3401731433676027
26,5,3,0,9,12,0.2190830684792641,0.1498403743848929
26,6,3,0,8,11,0.25520595792027084,0.17454637889393984
26,7,3,1,7,11,0.14208857931228164,0.0971805172702561
26,8,3,0,3,6,1.8176931161400183,1.243198842018418
26,9,3,0,2,5,3.7352720040774066,2.5547138781897334
26,10,3,0,1,4,3.749231491643347,2.5642613747517498
26,11,3,0,1,4,0.0650625283354143,0.04449907367044619
26,12,3,0,2,5,0.0010355168688937141,0.0007082347184286952
26,13,3,0,0,3,0.0011121603753482616,0.0007606545233047042
26,14,1,0,0,1,0.0039707333524185515,0.002715756065673739
26,15,3,1,1,5,0.30076128500982047,0.20570363496902738
26,16,3,2,5,10,7.724429141079329,5.283070766002406
26,17,3,2,5,10,7.53526694509785,5.15369456882715
26,18,3,0,7,10,0.09076800768311495,0.062080161410082074
26,19,2,0,19,21,0.02420939670612903,0.01655785219395952
26,20,2,0,0,2,0.0003765532770038195,0.00025754105232212837
26,21,2,0,1,3,0.2757299131627816,0.18858359846888695
26,22,1,0,4,5,0.339395442517114,0.2321272041892371
26,23,1,0,5,6,0.7760475310389104,0.5307724298299582
26,24,1,0,2,3,0.14321519785771403,0.09795106036063889
26,25,1,0,3,4,0.20380434782608695,0.13939059732687734
26,27,1,0,8,9,0.3488961387361574,0.238625140740246
26,28,1,0,7,8,0.23118664672727102,0.15811853439363793
26,29,2,0,17,19,0.424701361081412,0.29047160690208945
26,30,1,0,1,2,1.192446350300431,0.8155655697319539
26,31,2,1,27,30,1.0677625560633142,0.730288936818686
26,32,3,1,3,7,1.2328371369459257,0.8431905735018553
26,33,2,0,15,17,0.31446747990589957,0.2150778937325027
26,34,2,2,25,29,1.6563810220712436,1.132870532597446
26,35,3,0,3,6,0.6494078321605997,0.44415806924228823
26,36,2,0,18,20,0.760441611647626,0.520098867420767
26,37,2,1,21,24,1.0476920773136373,0.7165618694062618
26,38,1,0,12,13,0.7289397897423532,0.49855341061820696
26,39,1,0,10,11,0.3742121353219618,0.2559398443943197
26,40,2,1,28,31,1.574473511060878,1.0768504476136103
26,41,3,0,4,7,1.6393338908562454,1.1212112631651965
26,42,3,1,6,10,1.530812922279477,1.0469890849155192
26,43,1,0,6,7,0.09972676156645183,0.06820744018711986
26,44,2,0,16,18,0.46014924053037987,0.3147159429188028
26,45,2,0,13,15,0.14672794732838107,0.10035358146580087
26,46,2,0,12,14,0.1019803902718557,0.06974879420998546
26,47,2,0,8,10,1.069966603327384,0.7317963799520265
26,48,0,0,1,1,0.041099746826339316,0.02810989226292437
26,49,1,0,9,10,0.9058501052962936,0.6195500175178449
26,50,2,0,10,12,0.5080419613841843,0.34747184355894944
26,51,3,1,2,6,1.4564168955388805,0.9961064285014999
26,52,1,0,11,12,0.38285245199684953,0.26184933020879175
26,53,2,1,20,23,1.244180640556521,0.8509488856327121
26,54,2,2,26,30,1.3997762554056377,0.9573674479774601
26,55,2,1,26,29,2.0899021785008216,1.4293743785317015
26,56,2,0,14,16,0.2669200288010399,0.18255813798846673
26,57,3,0,5,8,2.6009967320240905,1.7789340217190743
26,58,2,1,19,22,2.2561643951134807,1.5430882905936048
26,59,3,2,7,12,0.2224256172332686,0.1521264878676753
26,60,2,1,25,28,0.7530050013798296,0.5150126484152732
26,61,2,0,11,13,0.28466158091249383,0.1946923518690842
26,62,2,1,12,15,0.12099450161675779,0.0827533663217999
26,63,3,2,8,13,0.3184095431801764,0.21777404109325815
26,64,2,0,1,3,0.12470069395949483,0.08528819136342883
26,65,2,0,2,4,0.24520082300741902,0.16770343492971937
26,66,2,0,3,5,0.4749851048282183,0.32486283138509237
26,67,2,0,4,6,0.6162999205265368,0.42151413829506634
26,68,2,0,5,7,0.970633147461764,0.6638579385235484
26,69,2,0,6,8,1.219789996484214,0.8342670705355812
26,70,2,1,24,27,1.4380423361372083,0.9835392735907378
26,71,2,1,23,26,1.6430527469927767,1.1237547495224463
26,72,2,1,22,25,1.9101519718481972,1.3064354474333344
26,73,2,0,7,9,1.0814386823590239,0.7396426303674789
26,74,2,0,9,11,0.5984183087587251,0.4092841315652318
26,75,3,0,4,7,0.1668082109453499,0.11408734117164841
26,76,3,0,5,8,2.0594986762590444,1.4085801099917254
26,77,3,1,8,12,0.4620828584725209,0.31603842775699187
26,78,3,1,4,8,6.039223643997812,4.130485929798717
27,0,3,0,0,3,0.0006557788034144744,0.00044851545169316586
27,1,2,0,6,8,0.22433304208644528,0.15343105812084434
27,2,2,1,5,8,4.378311136784801,2.9945161187637583
27,3,2,1,4,7,4.611367121185912,3.1539131739433435
27,4,2,1,5,8,4.805147303879461,3.2864478117166986
27,5,2,0,9,11,0.5184806837212527,0.35461133669250633
27,6,2,0,8,10,0.7531715283754015,0.515126543421103
27,7,2,1,7,10,0.12299596475571532,0.08412225342083805
27,8,2,0,3,5,0.7230130938539755,0.4944998872814002
27,9,2,0,2,4,1.7049000052137306,1.1660547610698198
27,10,2,0,1,3,1.8781872265671313,1.2845733773369135
27,11,2,0,1,3,0.04839522532708757,0.03309958515638739
27,12,2,0,2,4,0.001236209585807447,0.0008454971369597801
27,13,2,0,0,2,0.0033616563354071332,0.0022991819831044017
27,14,0,0,8,8,0.098452542897316,0.06733594699617249
27,15,2,1,1,4,0.2528328343630201,0.17292329718001126
27,16,2,2,5,9,10.51504543763628,7.191693799006226
27,17,2,2,5,9,10.578545260796057,7.235124071102018
27,18,2,0,7,9,0.07780336811947368,0.05321308437183495
27,19,1,0,19,20,0.03445249011459936,0.023563546252557625
27,20,1,0,0,1,0.004132036245618607,0.0028260780822231386
27,21,1,0,1,2,0.1268360061219983,0.08674862359162
27,22,0,0,4,4,0.03749638624903148,0.025645398307752875
27,23,0,0,3,3,0.27325286055865805,0.18688943519032178
27,24,0,0,6,6,0.2717676280425657,0.18587362051415954
27,25,0,0,5,5,0.10311774978809933,0.07052668351428967
27,26,0,1,8,9,0.37215588131856786,0.2545334834562624
27,28,0,0,1,1,0.11875,0.0812182547091272
27,29,1,0,17,18,0.7484381086820748,0.5118891532207005
27,30,0,0,7,7,0.4176268859131911,0.2856330677345445
27,31,1,1,27,29,1.4522658979838603,0.9932673819606949
27,32,2,1,3,6,1.8065469294761647,1.2355754834710466
27,33,1,0,15,16,0.7892815125938584,0.5398237214909741
27,34,1,2,25,28,2.351953236732775,1.6086024172203677
27,35,2,0,3,5,0.7373735813002169,0.5043216449837671
27,36,1,0,18,19,1.2217638618425328,0.8356170823202842
27,37,1,1,21,23,1.5879169464830962,1.0860449938223462
27,38,0,0,4,4,0.250466106643903,0.17130458985606678
27,39,0,0,2,2,0.8197327647200369,0.5606506482395706
27,40,1,1,28,30,2.36794081231659,1.6195370107862432
27,41,2,0,4,6,1.8561812817225811,1.2695225610548109
27,42,2,1,6,9,2.150902608250389,1.4710952075065777
27,43,0,0,2,2,0.1772951114331234,0.1212597854236506
27,44,1,0,16,17,0.93607195899303,0.6402200487710955
27,45,1,0,13,14,0.7084815812840116,0.4845611581090532
27,46,1,0,12,13,0.14671059948074644,0.10034171652341903
27,47,1,0,8,9,0.4846229425372581,0.33145456492528624
27,48,0,1,9,10,0.36824324324324326,0.25185746126016684
27,49,0,0,1,1,0.30788945803217577,0.2105789004186306
27,50,1,0,10,11,0.23755919710757328,0.1624769968772938
27,51,2,1,2,5,2.0879157935872583,1.4280158040823527
27,52,0,0,3,3,0.3421870833330797,0.2340365279353213
27,53,1,1,20,22,1.8079977283422681,1.2365677474865324
27,54,1,2,26,29,2.032253451727154,1.389945924007402
27,55,1,1,26,28,2.8454690676364827,1.9461392126504635
27,56,1,0,14,15,0.8956915281554623,0.6126021277855808
27,57,2,0,5,7,2.3094527490295187,1.579534497763145
27,58,1,1,19,21,3.076753672038211,2.1043247445291944
27,59,2,2,7,11,0.24989417581732004,0.17091342165775594
27,60,1,1,25,27,1.0803534564792057,0.7389003975091714
27,61,1,0,11,12,0.20289246349304063,0.1387669202403374
27,62,1,1,12,14,0.2191889633464527,0.14991280045896202
27,63,2,2,8,12,0.21151649823345534,0.14466527013648364
27,64,1,0,1,2,0.8475091053631633,0.5796480874752836
27,65,1,0,2,3,0.8952047819144511,0.6122692210051078
27,66,1,0,3,4,1.221657312019293,0.8355442082934791
27,67,1,0,4,5,1.2704203617337895,0.8688953644375279
27,68,1,0,5,6,1.7182165220313863,1.1751625021623227
27,69,1,0,6,7,1.9671499004568376,1.3454187929796857
27,70,1,1,24,26,2.1851663937483905,1.4945296905202674
27,71,1,1,23,25,2.3899569311293165,1.6345947854846723
27,72,1,1,22,24,2.6068960696689762,1.7829688335713476
27,73,1,0,7,8,0.4924035010321512,0.33677602498101256
27,74,1,0,9,10,0.2509945142298321,0.1716659906299971
27,75,2,0,4,6,0.2340265430367444,0.16006086215625115
27,76,2,0,5,7,2.807130645647739,1.9199179097264405
27,77,2,1,8,11,0.28708370289714424,0.19634894572412348
27,78,2,1,4,7,8.948666023844297,6.120379254159989
28,0,3,0,0,3,0.0005834402336045002,0.0003990399789510988
28,1,2,0,6,8,0.2605171269242804,0.1781789168052735
28,2,2,1,5,8,3.985566648839996,2.7259011978584367
28,3,2,1,4,7,4.183226390585908,2.86108923365515
28,4,2,1,5,8,4.338492705263359,2.967282573387536
28,5,2,0,9,11,0.41790738592110344,0.2858249138068691
28,6,2,0,8,10,0.5816696855082775,0.3978290246247511
28,7,2,1,7,10,0.09450270984011944,0.06463448554524262
28,8,2,0,3,5,1.013310179886276,0.6930466045419376
28,9,2,0,2,4,2.375822226093527,1.6249274501260604
28,10,2,0,1,3,2.5115037871107915,1.717725930816858
28,11,2,0,1,3,0.052641993211209014,0.03600413316230837
28,12,2,0,2,4,0.0011284461008770803,0.000771793034497315
28,13,2,0,0,2,0.002595529616742685,0.0017751948254121322
28,14,0,0,7,7,0.06464913259901472,0.0442163344686393
28,15,2,1,1,4,0.2637720104337542,0.18040507224039753
28,16,2,2,5,9,9.573157641145487,6.547496047740476
28,17,2,2,5,9,9.552681247077413,6.533491357307251
28,18,2,0,7,9,0.05881045606358419,0.0402230113695336
28,19,1,0,19,20,0.030951675787555765,0.02116918810768867
28,20,1,0,0,1,0.002787276918055123,0.0019063390877934487
28,21,1,0,1,2,0.17771446155825016,0.12154659708912299
28,22,0,0,3,3,0.12395054817967295,0.08477513426014838
28,23,0,0,2,2,0.44518905714582374,0.30448402725882695
28,24,0,0,5,5,0.1351161106576267,0.09241174476377047
28,25,0,0,4,4,0.033058492012490316,0.022610130733221774
28,26,0,1,7,8,0.24659908984242243,0.16865977001988047
28,27,0,0,1,1,0.11875,0.0812182547091272
28,29,1,0,17,18,0.6393359473929522,0.4372694721689427
28,30,0,0,6,6,0.6812513382823513,0.46593721864041926
28,31,1,1,27,29,1.3195213093738691,0.9024776235692459
28,32,2,1,3,6,1.597092324989572,1.0923204315368018
28,33,1,0,15,16,0.6299416882634812,0.4308443325413139
28,34,1,2,25,28,2.114672617162708,1.446315951554842
28,35,2,0,3,5,0.7012148419278206,0.4795911211580135
28,36,1,0,18,19,1.0659573063047734,0.7290542485264523
28,37,1,1,21,23,1.4052090175253087,0.9610831486731193
28,38,0,0,5,5,0.4100772051409895,0.2804695149267191
28,39,0,0,3,3,0.6621330220498665,0.45286137630459106
28,40,1,1,28,30,2.0930003958332537,1.4314933832007517
28,41,2,0,4,6,1.7648318782937868,1.2070447579793868
28,42,2,1,6,9,1.9406956808452938,1.327325609429862
28,43,0,0,1,1,0.08416618925309624,0.057564892603406956
28,44,1,0,16,17,0.7761036217423296,0.5308107926850075
28,45,1,0,13,14,0.512348178853708,0.35041705170440346
28,46,1,0,12,13,0.08683317338436963,0.05938895825796664
28,47,1,0,8,9,0.6840054909573519,0.46782090262750153
28,48,0,1,8,9,0.23986486486486486,0.16405394265570503
28,49,0,0,2,2,0.5111636384819663,0.3496068933749268
28,50,1,0,10,11,0.20820416105678352,0.14239981965650514
28,51,2,1,2,5,1.8590058573812447,1.2714544103625207
28,52,0,0,4,4,0.14289856542317003,0.09773450176090864
28,53,1,1,20,22,1.6170679978039586,1.1059826570746971
28,54,1,2,26,29,1.8165761928718327,1.2424349299469566
28,55,1,1,26,28,2.5863796133074186,1.7689367428050176
28,56,1,0,14,15,0.6837505341127041,0.4676465266279358
28,57,2,0,5,7,2.3687169522760634,1.6200678464318723
28,58,1,1,19,21,2.7983982088979484,1.9139454190133807
28,59,2,2,7,11,0.17893984332302937,0.12238468861154622
28,60,1,1,25,27,0.96869740558697,0.6625340010360693
28,61,1,0,11,12,0.13107681272817473,0.08964909442204179
28,62,1,1,12,14,0.13306619243913131,0.09100971714269562
28,63,2,2,8,12,0.1828379206166475,0.1250507520600426
28,64,1,0,1,2,0.6003592939963162,0.4106116552150281
28,65,1,0,2,3,0.6766387262197697,0.462782453997277
28,66,1,0,3,4,0.9703019990640825,0.6636314518295744
28,67,1,0,4,5,1.0496116283237815,0.7178747332620012
28,68,1,0,5,6,1.4652109446236394,1.0021210585519464
28,69,1,0,6,7,1.7137741052056623,1.1721241413936847
28,70,1,1,24,26,1.9315711211791995,1.3210849289155928
28,71,1,1,23,25,2.136210861107172,1.4610468869878424
28,72,1,1,22,24,2.369878432477544,1.6208622329147646
28,73,1,0,7,8,0.6937554552608233,0.47448932438922153
28,74,1,0,9,10,0.21961381921872936,0.1502033777427451
28,75,2,0,4,6,0.21125116908484673,0.14448380007018088
28,76,2,0,5,7,2.5543556800201146,1.7470341914743537
28,77,2,1,8,11,0.24721149321288285,0.16907861913926395
28,78,2,1,4,7,7.880901729642356,5.390089128553214
29,0,2,0,0,2,0.0006107695138187116,0.00041773165424756136
29,1,1,0,6,7,1.0929934464198587,0.7475454326461883
29,2,1,1,5,7,1.6919166595978337,1.1571748901543792
29,3,1,1,4,6,1.6803202788960865,1.1492436244572126
29,4,1,1,5,7,1.6073264742790678,1.0993200083260695
29,5,1,0,9,10,0.21874304655638427,0.14960781870372117
29,6,1,0,8,9,0.54022354477278,0.3694822186039851
29,7,1,1,7,9,0.38674075475257735,0.26450870842858887
29,8,1,0,3,4,3.7200401002015338,2.544296121148086
29,9,1,0,2,3,6.668767753398331,4.561058340981218
29,10,1,0,1,2,6.3655115933317346,4.35364835318837
29,11,1,0,1,2,0.09321865607678474,0.06375626570852069
29,12,1,0,2,3,0.0011720426941822504,0.0008016106279247637
29,13,1,0,0,1,0.0018761219500265194,0.0012831608454959011
29,14,0,1,17,18,0.1322209255662521,0.09043160261487505
29,15,1,1,1,3,0.3901842596820662,0.2668638702008445
29,16,1,2,5,8,4.066641051831898,2.781351484280219
29,17,1,2,5,8,3.5432627257658513,2.4233904384219556
29,18,1,0,7,8,0.25006327534501815,0.17102907612943405
29,19,0,0,2,2,0.011098243851421472,0.0075905683869368756
29,20,0,0,17,17,0.005044887984820729,0.003450416819622614
29,21,0,0,18,18,0.47110928378711464,0.32221198994910627
29,22,0,1,21,22,0.7806296920111243,0.5339063676569854
29,23,0,1,22,23,1.438577918611126,0.9839055815805011
29,24,0,1,19,20,0.6838837601587945,0.46773764567589593
29,25,0,1,20,21,0.5999974291935404,0.4103641602447366
29,26,0,2,17,19,0.4879346748424222,0.33371960170751164
29,27,0,1,25,26,0.8061302128929848,0.5513472754481296
29,28,0,1,24,25,0.6886180933378256,0.470975660648632
29,30,0,1,18,19,2.2323791928966115,1.526820563335013
29,31,0,1,10,11,0.5853090689738796,0.40031815618932765
29,32,1,1,3,5,0.7306866004386948,0.4997481299113783
29,33,0,0,2,2,0.3200031887596224,0.21886400414662674
29,34,0,2,8,10,0.7614006191078242,0.5207547740495698
29,35,1,0,3,4,0.5805071028509896,0.39703388412470886
29,36,0,0,1,1,0.15702479338842976,0.1073960392847963
29,37,0,1,4,5,0.34193928786685024,0.23386704991180976
29,38,0,1,29,30,1.3598399786271125,0.9300533031392919
29,39,0,1,27,28,0.32795722489072365,0.2243041130515647
29,40,0,1,11,12,0.6329239917199637,0.4328840587034066
29,41,1,0,4,5,1.4887381951678793,1.0182123615187466
29,42,1,1,6,8,0.7222245963873607,0.49396059980282314
29,43,0,1,23,24,0.4574616272140874,0.31287776807347834
29,44,0,0,1,1,0.16809116809116809,0.11496481098427962
29,45,0,0,4,4,0.7065240616832876,0.4832223258940661
29,46,0,0,5,5,0.38133391608347084,0.26081073790060016
29,47,0,0,9,9,1.8666675852437482,1.2766945970155634
29,48,0,2,18,20,0.5088906523482218,0.34805229997062553
29,49,0,1,26,27,1.6893140287569692,1.1553948384950348
29,50,0,0,7,7,1.314395303902881,0.8989717269967566
29,51,1,1,2,4,0.8519636223976285,0.5826947240993791
29,52,0,1,28,29,1.2471423334968628,0.8529745153724925
29,53,0,1,3,4,0.5084175084175084,0.3477286963977518
29,54,0,2,9,11,0.5873075217590732,0.4016849843773867
29,55,0,1,9,10,1.1250022956817716,0.7694376673602945
29,56,0,0,3,3,0.601926148923102,0.41168329498375195
29,57,1,0,5,6,3.1897065695765816,2.1815781104441867
29,58,0,1,2,3,1.1862770418057567,0.8113461131534307
29,59,1,2,7,10,0.6591745592550566,0.4508379558008746
29,60,0,1,8,9,0.33218516211599053,0.22719578195645668
29,61,0,0,6,6,0.8282061205042875,0.5664459422886343
29,62,0,1,5,6,0.4990909090909091,0.3413498322320447
29,63,1,2,8,11,0.8056859304928343,0.5510434115227552
29,64,0,0,16,16,0.8837538156976772,0.6044374105557644
29,65,0,0,15,15,0.617490283719737,0.4223282791036701
29,66,0,0,14,14,0.505835289321998,0.3459626052127923
29,67,0,0,13,13,0.24214024236515547,0.16561017161888836
29,68,0,0,12,12,0.060309178955831676,0.04124805269669955
29,69,0,0,11,11,0.25499240309812193,0.174400319526027
29,70,0,1,7,8,0.47039464881921766,0.3217232202240814
29,71,0,1,6,7,0.6745726278389835,0.4613693600642681
29,72,0,1,5,6,1.005740899508638,0.6878696467172991
29,73,0,0,10,10,1.8752027355793348,1.2825321550276592
29,74,0,0,8,8,1.556163811030254,1.0643276528284737
29,75,1,0,4,5,0.07908878041857942,0.05409223336985612
29,76,1,0,5,6,1.0809519097767484,0.7393097055710774
29,77,1,1,8,10,1.1805683210094144,0.8074416723980571
29,78,1,1,4,6,3.653010113754915,2.498451417886016
30,0,3,0,0,3,0.0008081679879946078,0.0005527409978670225
30,1,2,0,6,8,0.30534562866166237,0.20883906562493867
30,2,2,1,5,8,4.930724273326171,3.3723353257387885
30,3,2,1,4,7,5.212931854243643,3.565349281004488
30,4,2,1,5,8,5.460114862640709,3.7344084181477406
30,5,2,0,9,11,0.6575208248337556,0.4497068953928706
30,6,2,0,8,10,0.9912239823237476,0.6779408999592887
30,7,2,1,7,10,0.18897043559246868,0.12924504396163233
30,8,2,0,3,5,0.6751339016254234,0.46175323945246705
30,9,2,0,2,4,0.6925320891081108,0.4736526114309602
30,10,2,0,1,3,0.8468271920811119,0.5791816975247052
30,11,2,0,1,3,0.048553002405366655,0.033207495715805765
30,12,2,0,2,4,0.0014785509133433902,0.0010112448394133569
30,13,2,0,0,2,0.004470245560602393,0.0030573940425545286
30,14,0,0,1,1,0.1476685424897364,0.10099689512805882
30,15,2,1,1,4,0.2582394680264267,0.176621127495746
30,16,2,2,5,9,11.837701658495856,8.096315523961044
30,17,2,2,5,9,12.016256206620284,8.218436692542458
30,18,2,0,7,9,0.1215559765713529,0.08313738329759024
30,19,1,0,19,20,0.039516522384921066,0.0270270566760206
30,20,1,0,0,1,0.006104329606734371,0.0041750147101323664
30,21,1,0,1,2,0.05745242597140699,0.03929419592592007
30,22,0,0,3,3,0.1648786860827532,0.11276765576737073
30,23,0,0,4,4,0.05711538431809324,0.03906367857984494
30,24,0,0,1,1,0.47225086655639686,0.3229927677185978
30,25,0,0,2,2,0.24801313498053557,0.16962689657312238
30,26,0,1,1,2,0.5538250826950891,0.3787848979421742
30,27,0,0,7,7,0.18184170657470194,0.12436939824274959
30,28,0,0,6,6,0.2966281868771071,0.20287683061634923
30,29,1,0,17,18,0.9024511630858641,0.6172253341141541
30,31,1,1,27,29,1.6481703045586613,1.1272548682077062
30,32,2,1,3,6,2.1404049186766616,1.4639153841326298
30,33,1,0,15,16,1.0134694904945414,0.6931555639487582
30,34,1,2,25,28,2.693847478256909,1.8424386579925025
30,35,2,0,3,5,0.8082781201693358,0.5528163220187591
30,36,1,0,18,19,1.4421638894015423,0.9863581819092212
30,37,1,1,21,23,1.8467178467245693,1.2630501090624588
30,38,0,0,11,11,0.15376248556964717,0.105164806043824
30,39,0,0,9,9,1.0565355465440391,0.7226103000291426
30,40,1,1,28,30,2.775571482555212,1.8983332348089184
30,41,2,0,4,6,2.0402075757531373,1.3953860930274464
30,42,2,1,6,9,2.449566043144306,1.6753640321593524
30,43,0,0,5,5,0.31579201770317517,0.2159838023488479
30,44,1,0,16,17,1.1613941855587016,0.7943276528876292
30,45,1,0,13,14,0.9855688519747248,0.6740731120258129
30,46,1,0,12,13,0.24186773244895646,0.16542379031543894
30,47,1,0,8,9,0.16356161086482626,0.11186685113140721
30,48,0,1,2,3,0.5577599365520064,0.38147611447096824
30,49,0,0,8,8,0.12384672060285501,0.08470412209526561
30,50,1,0,10,11,0.45874402461435465,0.31375485505194756
30,51,2,1,2,5,2.4506465275061147,1.6761030220886712
30,52,0,0,10,10,0.6912741858336676,0.47279227704322824
30,53,1,1,20,22,2.078883967592896,1.4218385481320488
30,54,1,2,26,29,2.3428795827869284,1.6023965533271782
30,55,1,1,26,28,3.2227064366553004,2.2041481450527485
30,56,1,0,14,15,1.193811086915599,0.8164989720563463
30,57,2,0,5,7,2.3756674851502257,1.6248216161105071
30,58,1,1,19,21,3.472499508343796,2.374992417229351
30,59,2,2,7,11,0.38030704030575735,0.2601084131977036
30,60,1,1,25,27,1.241223320987967,0.8489262470308165
30,61,1,0,11,12,0.3711776485879886,0.2538644278345614
30,62,1,1,12,14,0.35068410121215243,0.23984800551317847
30,63,2,2,8,12,0.3261861313579249,0.22309278567758126
30,64,1,0,1,2,1.1994107622737773,0.8203288319260638
30,65,1,0,2,3,1.2056493657222263,0.8245956823168458
30,66,1,0,3,4,1.5786947723709053,1.0797375505716866
30,67,1,0,4,5,1.584419012116754,1.0836526054070084
30,68,1,0,5,6,2.0785577173394114,1.4216154114904789
30,69,1,0,6,7,2.3285112592193373,1.5925694361629195
30,70,1,1,24,26,2.5472280883955456,1.7421593236678115
30,71,1,1,23,25,2.7525588888999715,1.8825939279204214
30,72,1,1,22,24,2.9460992631029175,2.0149645503079134
30,73,1,0,7,8,0.1715084365705632,0.1173020285149658
30,74,1,0,9,10,0.5290979068428736,0.36187291422341533
30,75,2,0,4,6,0.26634732033636593,0.18216643792987341
30,76,2,0,5,7,3.163652853615386,2.163758848641613
30,77,2,1,8,11,0.46226872136904607,0.31616554742074726
30,78,2,1,4,7,10.658193001015933,7.289598601225676
31,0,3,0,0,3,0.0008170027185460971,0.0005587834517299056
31,1,2,0,6,8,1.8139174697278893,1.2406165143384864
31,2,2,1,5,8,0.6983397694832906,0.4776247349171122
31,3,2,1,4,7,0.7778812816477362,0.5320266110848687
31,4,2,1,5,8,0.917206450573238,0.6273171126190462
31,5,2,0,9,11,0.6840075660788786,0.4678223218927539
31,6,2,0,8,10,1.3512745571586933,0.9241950413918132
31,7,2,1,7,10,0.6865979264317283,0.46959398123529
31,8,2,0,3,5,5.95754435239418,4.074621933925666
31,9,2,0,2,4,10.079221785711216,6.893615176940442
31,10,2,0,1,3,9.393431178568786,6.424573356241319
31,11,2,0,1,3,0.12007317719218799,0.08212323274887821
31,12,2,0,2,4,0.0014353155194428066,0.0009816742858616344
31,13,2,0,0,2,0.00506297458817043,0.003462787028950437
31,14,1,1,19,21,0.27321055734565736,0.18686050219555542
31,15,2,1,1,4,0.4700832822895596,0.3215102632041768
31,16,2,2,5,9,1.7343146260763134,1.1861726909173114
31,17,2,2,5,9,2.0676173055751996,1.414132791285944
31,18,2,0,7,9,0.4438474267746942,0.3035664282928657
31,19,1,0,0,1,0.004567148616687713,0.0031236702285859425
31,20,1,0,19,20,0.010586424474499328,0.0072405130057164166
31,21,1,0,20,21,0.6830972778044702,0.46719973641966217
31,22,1,1,23,25,1.2637360779073423,0.8643236939839322
31,23,1,1,24,26,2.16040895441613,1.4775970083001972
31,24,1,1,21,23,1.2737773604158384,0.8711913608503015
31,25,1,1,22,24,1.0329018462601185,0.7064461914870067
31,26,1,2,19,22,1.0179336367803593,0.696208786433814
31,27,1,1,27,29,1.2979626463230751,0.887732722627371
31,28,1,1,26,28,1.1793221702528955,0.8065893760650135
31,29,1,0,2,3,0.48568199340385754,0.33217889556135693
31,30,1,1,20,22,3.38308641462041,2.3138389400052914
31,32,2,1,3,6,0.7490788910252835,0.5123274119454484
31,33,1,0,4,5,1.026399492579447,0.7019989509190439
31,34,0,1,2,3,0.31662554557570227,0.21655388806723158
31,35,2,0,3,5,0.47412361848121803,0.3242736236582789
31,36,1,0,1,2,0.5444030826140591,0.3723407850794331
31,37,0,0,6,6,0.4965568229920293,0.33961666128270845
31,38,1,1,31,33,2.0287361409592015,1.3875402832339894
31,39,1,1,29,31,0.9125,0.6240981677648723
31,40,0,0,1,1,0.642512077294686,0.4394417646097704
31,41,2,0,4,6,1.2524378234240654,0.8565963296858999
31,42,2,1,6,9,0.3268557863576012,0.22355079165931552
31,43,1,1,25,27,0.8408228259814061,0.5750750521752083
31,44,1,0,3,4,0.8768867925753728,0.5997407568038419
31,45,1,0,6,7,1.5973381965694373,1.0924885937313218
31,46,1,0,7,8,0.7073923946438779,0.4838162163156708
31,47,1,0,11,12,2.7663995359163587,1.8920601442969778
31,48,1,2,20,23,1.0353779000487806,0.7081396716325316
31,49,1,1,28,30,2.5313153493705958,1.7312759140572997
31,50,1,0,9,10,2.238531409373785,1.5310283299444345
31,51,2,1,2,5,0.7096372801963299,0.48535159051854987
31,52,1,1,30,32,2.1640009242142204,1.4800537116094084
31,53,0,0,7,7,0.39370910417535737,0.26927466361445457
31,54,0,1,3,4,0.3765702127290264,0.25755263539617923
31,55,0,0,1,1,0.12600832977844648,0.08618253998667423
31,56,1,0,5,6,1.5500835060536724,1.0601690696007082
31,57,2,0,5,7,3.680213580758595,2.517057044092974
31,58,0,0,8,8,0.38018648421997436,0.2600259596829091
31,59,2,2,7,11,1.202123494666696,0.8221841867929756
31,60,0,0,2,2,0.17021877954684986,0.11641997636642377
31,61,1,0,8,9,1.4543146940928247,0.9946686421225891
31,62,1,1,7,9,0.9440746048401748,0.6456934039606563
31,63,2,2,8,12,1.3937309021702857,0.953232769755351
31,64,1,0,18,19,1.9691725939387301,1.3468022004273559
31,65,1,0,17,18,1.568564889632648,1.072809286180871
31,66,1,0,16,17,1.5945969888220046,1.0906137633393924
31,67,1,0,15,16,1.1959282778665203,0.8179470104051445
31,68,1,0,14,15,1.10613883766405,0.7565361335667934
31,69,1,0,13,14,0.8668592238091841,0.5928824693582367
31,70,0,0,3,3,0.6640015353167952,0.45413933324304
31,71,0,0,4,4,0.4862691322766664,0.33258046519943213
31,72,0,0,5,5,0.2647145343992698,0.18104970509514032
31,73,1,0,12,13,2.765505716789142,1.8914488227850776
31,74,1,0,10,11,2.641056109899552,1.806332360715103
31,75,2,0,4,6,0.035917569483642844,0.024565577320886562
31,76,2,0,5,7,0.422022602674747,0.2886394883119696
31,77,2,1,8,11,2.0358669632499247,1.3924173606326713
31,78,2,1,4,7,4.115639099581105,2.8148633657315463
32,0,2,0,0,2,0.0004474260158818887,0.00030601397996955987
32,1,1,0,8,9,1.4256844892127116,0.9750872082503573
32,2,1,1,7,9,1.8322347824008542,1.2531445157385672
32,3,1,1,6,8,1.8977423939396356,1.2979480010383002
32,4,1,1,7,9,1.9432035117263946,1.329040823301598
32,5,1,0,11,12,0.5108109057845821,0.34936564424599725
32,6,1,0,10,11,1.0073532670593197,0.6889724145355391
32,7,1,1,9,11,0.5318574620735043,0.36376029325167014
32,8,1,0,5,6,4.726584303019858,3.232715181699615
32,9,1,0,4,5,8.144317610237199,5.570250628212842
32,10,1,0,3,4,7.652329490030486,5.233758700121782
32,11,1,0,1,2,0.09190620780380943,0.06285862564008227
32,12,1,0,0,1,0.0008284525155217734,0.0005666144624847541
32,13,1,0,2,3,0.0033581438436520077,0.002296779638262031
32,14,1,2,21,24,0.1906428307522566,0.13038886725478574
32,15,1,1,1,3,0.3650424800701312,0.24966832106094658
32,16,1,2,7,10,4.441854279965119,3.0379760192929166
32,17,1,2,7,10,4.321768845092623,2.9558444029869735
32,18,1,0,9,10,0.3430608318257111,0.2346341222732266
32,19,1,1,2,4,0.010838716643849364,0.007413066518738644
32,20,1,1,21,23,0.007275965355140059,0.004976347010261478
32,21,1,1,22,24,0.5449958604270797,0.3727462114323074
32,22,1,2,25,28,0.9660537621901224,0.660725899118046
32,23,1,2,26,29,1.6995874019909738,1.16242124223433
32,24,1,2,23,26,0.9253562033255488,0.632891080575708
32,25,1,2,24,27,0.7707103863189597,0.527122126004405
32,26,1,3,21,25,0.7150455394286368,0.4890505326310761
32,27,1,2,29,32,0.9823098929026646,0.6718441691373817
32,28,1,2,28,31,0.8684189517130798,0.5939492346481361
32,29,1,1,4,6,0.3688766009951632,0.2522906419862084
32,30,1,2,22,25,2.6729458553809025,1.8281431352086908
32,31,1,2,10,13,0.45573331132307454,0.31169569817660153
32,33,1,1,6,8,0.7264183873425754,0.49682891459859124
32,34,1,3,8,12,0.7687754060842477,0.525798709435479
32,35,1,0,1,2,0.41324006520758244,0.28263273155406965
32,36,1,1,3,5,0.48912619571803595,0.33453453430512714
32,37,1,2,4,7,0.5836058032703428,0.3991532191977725
32,38,1,2,33,36,1.5727194208338584,1.0756507495349503
32,39,1,2,31,34,0.5252883540858979,0.35926739652957185
32,40,1,2,11,14,0.5118265724738428,0.3500603025690957
32,41,1,0,2,3,1.0496670650065174,0.7179126488040531
32,42,1,1,8,10,0.7989039988955513,0.5464049555405402
32,43,1,2,27,30,0.6008457886274212,0.41094438990861726
32,44,1,1,5,7,0.6256724209684851,0.42792439621637623
32,45,1,1,8,10,1.1586401927251953,0.7924440782230496
32,46,1,1,9,11,0.5309969658837778,0.36317176273618856
32,47,1,1,13,15,2.227700808374494,1.523620814065585
32,48,1,3,22,26,0.7137587805884684,0.4881704626754549
32,49,1,2,30,33,1.976973632828207,1.3521376679096409
32,50,1,1,11,13,1.7186965201630475,1.1754907936193093
32,51,0,0,1,1,0.1271004086889137,0.08692945992867669
32,52,1,2,32,35,1.5441722701823135,1.0561261200373755
32,53,1,2,3,6,0.6540051947241411,0.4473024040942958
32,54,1,3,9,13,0.6433068417232146,0.4399853383343177
32,55,1,2,9,12,0.9713722507807071,0.6643634432108265
32,56,1,1,7,9,1.109817006079042,0.7590517918336726
32,57,1,0,3,4,2.9020441071768706,1.984833326095265
32,58,1,2,2,5,1.2081841772476083,0.8263293494167036
32,59,1,2,9,12,0.9259386380834557,0.6332894328663955
32,60,1,2,8,11,0.346722169720626,0.23713826942038765
32,61,1,1,10,12,1.1069924486616065,0.7571199550019266
32,62,1,2,9,12,0.7058182052362882,0.4827395601786937
32,63,1,2,10,13,1.084508781454606,0.7417424037597083
32,64,1,1,20,22,1.4034091202500503,0.9598521211754166
32,65,1,1,19,21,1.097541558732302,0.7506560831239798
32,66,1,1,18,20,1.097202095975607,0.7504239098807165
32,67,1,1,17,19,0.8196100042593619,0.5605666870575637
32,68,1,1,16,18,0.7966530052926661,0.5448654037781173
32,69,1,1,15,17,0.7331833307953219,0.5014557516549114
32,70,1,2,7,10,0.7450744402783674,0.5095885950971691
32,71,1,2,6,9,0.8116226130067332,0.5551037651441536
32,72,1,2,5,8,0.9827704073745359,0.6721591348777917
32,73,1,1,14,16,2.2250735342714467,1.5218239078147053
32,74,1,1,12,14,2.019863592364644,1.381471963977805
32,75,1,0,6,7,0.0878761623156932,0.0601023034426659
32,76,1,0,7,8,1.1546933467927971,0.7897446597958059
32,77,1,1,10,12,1.578737008514233,1.0797664376946063
32,78,0,0,1,1,0.3143376380761059,0.21498908929625776
33,0,2,0,0,2,0.0005556442229363044,0.0003800290865355439
33,1,1,0,6,7,0.7666508310844219,0.5243456208166623
33,2,1,1,5,7,2.4674408546390683,1.6875893878886938
33,3,1,1,4,6,2.5257682554172423,1.72748201688173
33,4,1,1,5,7,2.5287804474077737,1.72954218510337
33,5,1,0,9,10,0.04947916643077769,0.033840939300801676
33,6,1,0,8,9,0.18949749797088036,0.1296055246900318
33,7,1,1,7,9,0.251754541059313,0.17218580580997644
33,8,1,0,3,4,2.7046409456022253,1.8498207765613153
33,9,1,0,2,3,5.116439327197078,3.499353873516528
33,10,1,0,1,2,4.985258714504301,3.409633785814791
33,11,1,0,1,2,0.0798337024590344,0.05460171773213079
33,12,1,0,2,3,0.0011013029420477783,0.0007532286556559799
33,13,1,0,0,1,0.0005663318426083356,0.000387338811308237
33,14,0,1,15,16,0.06761260239236155,0.046243179474945384
33,15,1,1,1,3,0.3487632585269319,0.23853425822505714
33,16,1,2,5,8,5.9260840546031925,4.053104877258605
33,17,1,2,5,8,5.567949902405954,3.8081614600527725
33,18,1,0,7,8,0.16261653320137667,0.11122047169233391
33,19,0,0,4,4,0.017890764971383307,0.012236267001153182
33,20,0,0,15,15,0.0025284212010239226,0.0017292964809828906
33,21,0,0,16,16,0.3715736860239274,0.2541352949448471
33,22,0,1,19,20,0.5554095308550219,0.3798685704830317
33,23,0,1,20,21,1.1006342607520585,0.7527713156324431
33,24,0,1,17,18,0.41039124309948666,0.28068429905220593
33,25,0,1,18,19,0.39853116717495246,0.27257268080118774
33,26,0,2,15,17,0.24458581770458857,0.167282806236391
33,27,0,1,23,24,0.5755177695996884,0.39362146358716865
33,28,0,1,22,23,0.45933248102545504,0.31415732581137473
33,29,0,0,2,2,0.21663658813514092,0.14816712079558872
33,30,0,1,16,17,1.6971977113544952,1.1607868295792603
33,31,0,1,12,13,0.8373888634098053,0.5727264168337188
33,32,1,1,3,5,0.9741242742141815,0.6662456709176511
33,34,0,2,10,12,1.224321311425686,0.83736623256576
33,35,1,0,3,4,0.622244000520247,0.4255795513724607
33,36,0,0,3,3,0.4655667758770024,0.3184212293666149
33,37,0,1,6,7,0.7032332050513432,0.48097156688653364
33,38,0,1,27,28,1.0432300990209384,0.7135101297053522
33,39,0,1,25,26,0.2215005643333669,0.15149380422941314
33,40,0,1,13,14,1.1161014797099793,0.7633500148237379
33,41,1,0,4,5,1.582438374017051,1.082297961451907
33,42,1,1,6,8,1.137037037037037,0.7776687468445085
33,43,0,1,21,22,0.27956461056624154,0.19120631367264812
33,44,0,0,1,1,0.15100387019399478,0.1032780698229882
33,45,0,0,2,2,0.30074646332532085,0.2056934977787376
33,46,0,0,3,3,0.232,0.1586748218317264
33,47,0,0,7,7,1.451851851851852,0.9929841979252355
33,48,0,2,16,18,0.2690003950999241,0.183980990367002
33,49,0,1,24,25,1.2929126369305444,0.8842788030557832
33,50,0,0,5,5,0.8901515151515151,0.6088130735771895
33,51,1,1,2,4,1.1555365666842587,0.7903213743046104
33,52,0,1,26,27,0.8200390234616887,0.5608601118226136
33,53,0,1,5,6,0.885523485807211,0.6056477643890884
33,54,0,2,11,13,1.0072944754334507,0.6889322044029531
33,55,0,1,11,12,1.6266838065867535,1.1125593240806362
33,56,0,0,1,1,0.17119705591120055,0.11708906183114592
33,57,1,0,5,6,2.9236962906567436,1.9996421896984407
33,58,0,1,4,5,1.7353010413066707,1.1868473429040747
33,59,1,2,7,10,0.4151186038880173,0.2839175453058886
33,60,0,1,10,11,0.5498068585415667,0.3760366608661393
33,61,0,0,4,4,0.541025641025641,0.3700308068799102
33,62,0,1,3,4,0.2954559440526338,0.20207508311067326
33,63,1,2,8,11,0.5401942310467929,0.3694621696805014
33,64,0,0,14,14,0.38608329116504997,0.2640590406802623
33,65,0,0,13,13,0.18484654015751317,0.12642453373148477
33,66,0,0,12,12,0.0580786242466861,0.0397224799766151
33,67,0,0,11,11,0.20748218873575175,0.1419060315987157
33,68,0,0,10,10,0.5011396848556747,0.3427510784796625
33,69,0,0,9,9,0.7500166080218981,0.5129687571065107
33,70,0,1,9,10,0.9682587011272729,0.6622339521051244
33,71,0,1,8,9,1.1733111947636286,0.8024782102684863
33,72,0,1,7,8,1.4718303985929295,1.0066483890657412
33,73,0,0,8,8,1.4634615920190317,1.0009246007379073
33,74,0,0,6,6,1.056265943757218,0.7224259070370558
33,75,1,0,4,5,0.12405062750024695,0.08484358283067046
33,76,1,0,5,6,1.5801695434456275,1.080746210216187
33,77,1,1,8,10,0.7926806524100655,0.5421485400457922
33,78,1,1,4,6,4.778655043161222,3.268328610210723
34,0,4,0,0,4,0.0007789680227699381,0.0005327698802828971
34,1,3,0,6,9,1.6258236805166135,1.1119710467059283
34,2,3,1,5,9,0.5619424534484421,0.3843367184509257
34,3,3,1,4,8,0.5000143478198517,0.34198141186905967
34,4,3,1,5,9,0.44601308150667157,0.3050476131150448
34,5,3,0,9,12,0.557483815585037,0.3812872634139085
34,6,3,0,8,11,1.1335180047655518,0.7752619286604653
34,7,3,1,7,11,0.6078428340677023,0.41572997154044966
34,8,3,0,3,6,5.375774016919959,3.6767240704413733
34,9,3,0,2,5,9.196733623217526,6.290043401284003
34,10,3,0,1,4,8.611785893292387,5.889972380479072
34,11,3,0,1,4,0.11468507124592041,0.07843807433924686
34,12,3,0,2,5,0.0013989870043696483,0.0009568276451002352
34,13,3,0,0,3,0.004245685087234215,0.002903807434355633
34,14,2,1,19,22,0.23759862643664523,0.1625039642986966
34,15,3,1,1,5,0.4567330084909646,0.3123794342541905
34,16,3,2,5,10,1.3868679741697758,0.948538916834123
34,17,3,2,5,10,1.034368094718655,0.7074490221461419
34,18,3,0,7,10,0.3930613099596026,0.26883160916717647
34,19,2,0,0,2,0.000508539027872407,0.0003478118088022997
34,20,2,0,19,21,0.009192268837397382,0.006286989741393795
34,21,2,0,20,22,0.6305853745059556,0.43128457736821113
34,22,2,1,23,26,1.1424604125774789,0.7813780276531556
34,23,2,1,24,27,1.980636868756348,1.3546431132037158
34,24,2,1,21,24,1.1247462414276155,0.7692625407949605
34,25,2,1,22,25,0.9239574442300696,0.631934408807343
34,26,2,2,19,23,0.8834032117713299,0.6041976173853045
34,27,2,1,27,30,1.1759766183663876,0.8043012086101838
34,28,2,1,26,29,1.057336308581354,0.723157975777421
34,29,2,0,2,4,0.3534548328546959,0.24174302857233412
34,30,2,1,20,23,3.093413372161044,2.1157190331014384
34,31,1,0,2,3,0.17713317235004322,0.12114902828936033
34,32,3,1,3,7,0.7069199136406875,0.4834930661475669
34,33,2,0,4,6,0.8395346135490417,0.5741939880450926
34,35,3,0,3,6,0.5191228144287721,0.3550505176218526
34,36,2,0,1,3,0.34916200718787926,0.23880697965924447
34,37,1,0,4,5,0.25788804450062813,0.17638077376581682
34,38,2,1,31,34,1.8657376809369286,1.2760585952905412
34,39,2,1,29,32,0.7620039876276855,0.5211674438443451
34,40,1,0,3,4,0.4294493075336569,0.29371893258043663
34,41,3,0,4,7,1.358867276838728,0.9293880303678811
34,42,3,1,6,10,0.1167841853735375,0.07987374916771281
34,43,2,1,25,28,0.7453134542694951,0.5097520670905203
34,44,2,0,3,5,0.6871503114480332,0.4699717812096205
34,45,2,0,6,8,1.3645586063215156,0.9332805764526525
34,46,2,0,7,9,0.6231193928756974,0.4261782700191587
34,47,2,0,11,13,2.537305338611084,1.7353727264517327
34,48,2,2,20,24,0.9035132451475905,0.6179517379155124
34,49,2,1,28,31,2.323737862380614,1.5893047038658652
34,50,2,0,9,11,2.000918959275616,1.368514911046473
34,51,3,1,2,6,0.7026981729179479,0.4806056352984269
34,52,2,1,30,33,1.9399268027428251,1.326799740481933
34,53,1,0,5,6,0.13810871583834133,0.09445851672007476
34,54,0,0,1,1,0.10607751488591247,0.0725509947192865
34,55,1,0,1,2,0.29754505180096624,0.20350391414409535
34,56,2,0,5,7,1.300944126894685,0.8897718859829529
34,57,3,0,5,8,3.616020464543861,2.4731525989283347
34,58,1,0,6,7,0.33330629936510786,0.22796257615151103
34,59,3,2,7,12,1.0592718190830912,0.7244817550188717
34,60,1,0,0,1,0.026470588235294117,0.018104378758690896
34,61,2,0,8,10,1.293020382438618,0.8843524948630967
34,62,2,1,7,10,0.8288940156957332,0.5669164235254514
34,63,3,2,8,13,1.239772215930124,0.8479337735975736
34,64,2,0,18,20,1.6888281338138658,1.155062513953975
34,65,2,0,17,19,1.321612017649398,0.9039075492723564
34,66,2,0,16,18,1.309748695516878,0.8957937107994686
34,67,2,0,15,17,0.9432279443899682,0.6451143363051024
34,68,2,0,14,16,0.8108057295816608,0.5545450632823834
34,69,2,0,13,15,0.5620392103577755,0.38440289468088035
34,70,1,0,1,2,0.34583090012257706,0.2365286916416185
34,71,1,0,2,3,0.14973669492186095,0.10241139391550802
34,72,1,0,3,4,0.2597157233292671,0.17763080226797162
34,73,2,0,12,14,2.5397766912112023,1.7370629912513327
34,74,2,0,10,12,2.363467232625381,1.6164773363877407
34,75,3,0,4,7,0.013920948120754478,0.009521137770644067
34,76,3,0,5,8,0.3410725972306081,0.23327428274677126
34,77,3,1,8,12,1.8129156877513806,1.2399313523702247
34,78,3,1,4,8,3.827323406745652,2.6176718088696664
35,0,1,0,0,1,0.0009340789149593803,0.0006388569198618621
35,1,0,0,9,9,2.5914500479686238,1.7724046321001732
35,2,0,1,8,9,4.451498579425074,3.0445721723036936
35,3,0,1,7,8,4.861656469474257,3.3250968711245164
35,4,0,1,8,9,5.314680951658554,3.634939884038324
35,5,0,0,12,12,1.361711880170874,0.9313335774666323
35,6,0,0,11,11,2.4615711054737153,1.6835748128757222
35,7,0,1,10,11,1.030822150859884,0.7050237979650393
35,8,0,0,6,6,8.2796399690161,5.6628034349761665
35,9,0,0,5,5,13.37675582682951,9.14894115305466
35,10,0,0,4,4,12.220446622488954,8.358091338480852
35,11,0,0,2,2,0.12010604551267005,0.08214571281308683
35,12,0,0,1,1,0.001416967796496905,0.000969125485562243
35,13,0,0,3,3,0.009305230559995065,0.006364249143148073
35,14,0,2,22,24,0.43817711611938726,0.29968825789217013
35,15,0,1,2,3,0.4158887118288522,0.2844442553934023
35,16,0,2,8,10,10.741928494352294,7.346868922286618
35,17,0,2,8,10,11.746710459169844,8.034082712145052
35,18,0,0,10,10,0.6652239290772645,0.45497538114024116
35,19,0,1,3,4,0.03592569770909714,0.024571136565394183
35,20,0,1,22,23,0.017099873533197685,0.011695342182005157
35,21,0,1,23,24,0.8507163519901138,0.5818416619886533
35,22,0,2,26,28,1.725788540677555,1.1803413328070955
35,23,0,2,27,29,2.774755012804475,1.897774815876896
35,24,0,2,24,26,1.9202341503567506,1.3133310848407498
35,25,0,2,25,27,1.4752120382909382,1.008961238533761
35,26,0,3,22,25,1.645166508140186,1.1252004420804635
35,27,0,2,30,32,1.751262255588015,1.1977639068364467
35,28,0,2,29,31,1.665385249578574,1.139028912750282
35,29,0,1,5,6,1.2800350043522788,0.8754712338533231
35,30,0,2,23,25,4.408789746378195,3.0153617564659583
35,31,0,2,11,13,1.2599089162437962,0.8617061327982236
35,32,0,1,2,3,1.8049566066538083,1.2344877929947868
35,33,0,1,7,8,2.0267376016945184,1.3861733958988716
35,34,0,3,9,12,2.4658333685366673,1.6864899587037996
35,36,0,1,4,5,1.7726737594693645,1.2124081592654226
35,37,0,2,5,7,2.03851571147522,1.3942289539633859
35,38,0,2,34,36,2.5536035586778785,1.7465197831985988
35,39,0,2,32,34,1.7554951202677693,1.2006589458403165
35,40,0,2,12,14,2.6878501624248896,1.8383368346256306
35,41,0,0,1,1,0.11930282481532582,0.08159635548100645
35,42,0,1,9,10,2.2907280157735133,1.5667278438267516
35,43,0,2,28,30,1.2469729249269512,0.8528586495334946
35,44,0,1,6,7,1.9521704517409297,1.3351737009273832
35,45,0,1,9,10,2.7340383809513384,1.8699269524937732
35,46,0,1,10,11,1.0793125384037543,0.738188468672259
35,47,0,1,14,15,3.5741278061591397,2.444500400198796
35,48,0,3,23,26,1.6398500013555706,1.1215642534303942
35,49,0,2,31,33,3.222521690527213,2.2040217891951697
35,50,0,1,12,13,3.2206192974830903,2.2027206604135743
35,51,0,1,1,2,1.9195279819817974,1.3128481057843753
35,52,0,2,33,35,3.0547012947258856,2.0892421710766116
35,53,0,2,4,6,2.0996586832568793,1.4360472735914769
35,54,0,3,10,13,2.256318607161851,1.5431937628750678
35,55,0,2,10,12,2.5818992064750894,1.7658723990297869
35,56,0,1,8,9,2.8199265853467823,1.928669605639868
35,57,0,0,2,2,2.9800107382356864,2.038158073043875
35,58,0,2,3,5,3.0294752198443384,2.071988968760477
35,59,0,2,10,12,1.8378648588879547,1.2569951682536087
35,60,0,2,9,11,1.1632624580585136,0.7956054451550464
35,61,0,1,11,12,2.138237090846859,1.462432713034976
35,62,0,2,10,12,1.4590413472182897,0.9979014043749319
35,63,0,2,11,13,2.0528231901180924,1.4040144566552781
35,64,0,1,21,22,3.3242483050587883,2.273597015213887
35,65,0,1,20,21,2.820183325686207,1.9288452014485542
35,66,0,1,19,20,3.117549313115453,2.132226645733688
35,67,0,1,18,19,2.63177560372634,1.7999850216481086
35,68,0,1,17,18,2.8990311445118158,1.982772630776027
35,69,0,1,16,17,2.816827205460235,1.926549805849839
35,70,0,2,8,10,2.761507152882447,1.8887140322011222
35,71,0,2,7,9,2.724576101238746,1.863455290651025
35,72,0,2,6,8,2.516697709521569,1.7212782787183143
35,73,0,1,15,16,3.5485160039726225,2.4269833823163176
35,74,0,1,13,14,3.7777519291337778,2.5837677339644953
35,75,0,0,7,7,0.24923936446551556,0.17046556788801037
35,76,0,0,8,8,2.8348644892680066,1.938886283412453
35,77,0,1,11,12,2.982883935251346,2.0401231765979584
35,78,0,1,3,4,9.334841903128375,6.384501619854435
36,0,2,0,0,2,0.0006630691472861865,0.00045350163279202763
36,1,1,0,6,7,1.2593491215620627,0.8613232650336269
36,2,1,1,5,7,1.2984904132857746,0.8880936852514012
36,3,1,1,4,6,1.2519096982458373,0.8562351220627957
36,4,1,1,5,7,1.1413339835789797,0.7806076142021086
36,5,1,0,9,10,0.32273472525513225,0.22073221995159178
36,6,1,0,8,9,0.7237219820737926,0.4949847265571678
36,7,1,1,7,9,0.4556366699717626,0.31162960098176967
36,8,1,0,3,4,4.237438899825231,2.8981675105715317
36,9,1,0,2,3,7.459474488532134,5.101856833733383
36,10,1,0,1,2,7.068469975499897,4.834431956833422
36,11,1,0,1,2,0.10037679899707186,0.06865202886594565
36,12,1,0,2,3,0.0012443553419167971,0.0008510683714396756
36,13,1,0,0,1,0.0026255751320057755,0.001795744251193224
36,14,0,1,18,19,0.16570753997285356,0.11333454474726821
36,15,1,1,1,3,0.4129552008618303,0.28243790052256773
36,16,1,2,5,8,3.124244353084082,2.1368056727775606
36,17,1,2,5,8,2.520986295247645,1.7242114277527765
36,18,1,0,7,8,0.29467033039312696,0.2015377679923508
36,19,0,0,1,1,0.007697921849887963,0.005264941284506579
36,20,0,0,18,18,0.006364253987930247,0.00435278822252882
36,21,0,0,19,19,0.5218156128375429,0.3568922387759062
36,22,0,1,22,23,0.8954145222273601,0.612412671465374
36,23,0,1,23,24,1.6107428887972268,1.101656641795777
36,24,0,1,20,21,0.8237926647640947,0.5634273892574391
36,25,0,1,21,22,0.7028063307948607,0.48067960914260294
36,26,0,2,18,20,0.6134229000624184,0.41954641971941875
36,27,0,1,26,27,0.9239589205184155,0.6319354185047149
36,28,0,1,25,26,0.8061302128929848,0.5513472754481296
36,29,0,0,1,1,0.1102514506769826,0.07540572971060167
36,30,0,1,19,20,2.5048109658026787,1.7131484212107524
36,31,0,1,9,10,0.4606487622118962,0.3150575873749049
36,32,1,1,3,5,0.6802789618607167,0.4652721684013837
36,33,0,0,3,3,0.4828592561238625,0.330248303600232
36,34,0,2,7,9,0.5281075358716675,0.3611955567346073
36,35,1,0,3,4,0.5644566444626135,0.38605628229241096
36,37,0,1,3,4,0.1580727450129241,0.10811277866973122
36,38,0,1,30,31,1.5217090971766503,1.0407625856647509
36,39,0,1,28,29,0.45973061422350475,0.31442962630389987
36,40,0,1,10,11,0.4409122399653966,0.3015589272411065
36,41,1,0,4,5,1.4559623951380891,0.9957955760440946
36,42,1,1,6,8,0.5111144659041805,0.3495732621248442
36,43,0,1,24,25,0.5492244258863354,0.3756383100135625
36,44,0,0,2,2,0.33048433048433046,0.226032509731804
36,45,0,0,5,5,0.9130452754755718,0.6244711052171806
36,46,0,0,6,6,0.4573338192417244,0.3127903546801879
36,47,0,0,10,10,2.0777786030235372,1.4210825415540222
36,48,0,2,19,21,0.6345648276523578,0.434006297277664
36,49,0,1,27,28,1.8915376128473695,1.2937042832179546
36,50,0,0,8,8,1.5303042022947808,1.0466411493425283
36,51,1,1,2,4,0.762471538630933,0.5214872221725241
36,52,0,1,29,30,1.4690799842078033,1.004767261856589
36,53,0,1,2,3,0.3164983164983165,0.216466870605223
36,54,0,2,8,10,0.37697006997204585,0.25782611503753367
36,55,0,1,8,9,0.8726858418196073,0.5968675451111913
36,56,0,0,4,4,0.8211560979972727,0.5616241273523833
36,57,1,0,5,6,3.3393083116118523,2.283897204250922
36,58,0,1,1,2,0.9068660572276559,0.6202448709303384
36,59,1,2,7,10,0.7837956755255844,0.5360717205452575
36,60,0,1,7,8,0.222808003406881,0.15238801828995488
36,61,0,0,7,7,0.9743598178134002,0.6664067693600634
36,62,0,1,6,7,0.6027272727272728,0.4122312181600103
36,63,1,2,8,11,0.9410953356801861,0.6436557530850099
36,64,0,0,17,17,1.1377580512968548,0.7781618796428478
36,65,0,0,16,16,0.8395484582616606,0.5742034570421103
36,66,0,0,15,15,0.7590926818362479,0.5191762760523019
36,67,0,0,14,14,0.4620038644868474,0.31598440035784303
36,68,0,0,13,13,0.2636764514436554,0.1803397153191547
36,69,0,0,12,12,0.060638739764313054,0.04147345356983965
36,70,0,1,6,7,0.22045165402011407,0.15077640915582327
36,71,0,1,5,6,0.4217391599141607,0.2884456295639717
36,72,0,1,4,5,0.7687274161091029,0.5257658870184281
36,73,0,0,11,11,2.084741180165669,1.4258445488278042
36,74,0,0,9,9,1.8105774682390414,1.2383321430403802
36,75,1,0,4,5,0.0562080630210747,0.03844312235075637
36,76,1,0,5,6,0.8273575332845244,0.565865556832149
36,77,1,1,8,10,1.3782338689816127,0.9426336793237429
36,78,1,1,4,6,3.4904163843226086,2.3872465426764164
37,0,3,0,0,3,0.0007187116754650088,0.0004915579614344477
37,1,2,0,6,8,1.4023417418975888,0.9591220950120377
37,2,2,1,5,8,0.9612789372580932,0.65746019008629
37,3,2,1,4,7,0.8855052823909819,0.6056353142863863
37,4,2,1,5,8,0.7447766795747288,0.5093849436894177
37,5,2,0,9,11,0.41273894170898107,0.2822899915460685
37,6,2,0,8,10,0.8818417312235265,0.6031296533865269
37,7,2,1,7,10,0.5148680146830039,0.3521404762787946
37,8,2,0,3,5,4.682149149819667,3.2023240609362285
37,9,2,0,2,4,8.13906072059794,5.566655214303797
37,10,2,0,1,3,7.672630927908032,5.247643730458624
37,11,2,0,1,3,0.10671464754587492,0.0729867572680051
37,12,2,0,2,4,0.0013240549765346412,0.0009055783943838141
37,13,2,0,0,2,0.00327773711827502,0.002241786005403126
37,14,1,1,19,21,0.19465332358636972,0.13313181654750258
37,15,2,1,1,4,0.4334734724969206,0.296471232832882
37,16,2,2,5,9,2.3174758778560016,1.5850218621470895
37,17,2,2,5,9,1.65357114169943,1.1309487340312132
37,18,2,0,7,9,0.3330169201816309,0.22776465722745928
37,19,1,0,0,1,0.004905231178867972,0.0033548994971995894
37,20,1,0,19,20,0.007507596111970076,0.005134769290738852
37,21,1,0,20,21,0.5654657149718924,0.3867464292030811
37,22,1,1,23,25,0.9942252401648218,0.6799935898437867
37,23,1,1,24,26,1.75893886535256,1.2030142718651573
37,24,1,1,21,23,0.9443702060711793,0.6458955784117895
37,25,1,1,22,24,0.7913499888958334,0.5412384417870044
37,26,1,2,19,22,0.7217434310382835,0.4936315100354248
37,27,1,1,27,29,1.0255296946036663,0.7014040585102652
37,28,1,1,26,28,0.9075308238184285,0.6206995335180563
37,29,1,0,2,3,0.2050312944656162,0.14022975913474087
37,30,1,1,20,22,2.7391508731321363,1.8734236067433603
37,31,0,0,6,6,0.358817284679555,0.245410641020139
37,32,2,1,3,6,0.6931716437310586,0.47409003046478726
37,33,1,0,4,5,0.6228636959026183,0.42600338781378694
37,34,0,1,4,5,0.33310539081331136,0.22782516611418008
37,35,2,0,3,5,0.5543332197871212,0.3791324348496927
37,36,1,0,1,2,0.13499325331682221,0.09232771732125808
37,38,1,1,31,33,1.6613520098782943,1.136270405893185
37,39,1,1,29,31,0.5841693744323571,0.3995386698603678
37,40,0,0,7,7,0.3743961352657005,0.2560656899041895
37,41,2,0,4,6,1.4380501757733763,0.9835446354565661
37,42,2,1,6,9,0.32965043629713525,0.22546217347499486
37,43,1,1,25,27,0.6285436088463744,0.42988812563434836
37,44,1,0,3,4,0.4700876284160069,0.32151323570779616
37,45,1,0,6,7,1.0905797101449275,0.7458945741402682
37,46,1,0,7,8,0.5226683673441719,0.35747547441989574
37,47,1,0,11,12,2.2592622950799273,1.5452070782023481
37,48,1,2,20,23,0.7435161933968599,0.5085228427424577
37,49,1,1,28,30,2.0657688999399673,1.412868586825413
37,50,1,0,9,10,1.715913271785662,1.1735872098245028
37,51,2,1,2,5,0.7419036372362953,0.5074199459257713
37,52,1,1,30,32,1.6615558973444138,1.1364098533387033
37,53,0,0,1,1,0.1515245040136336,0.10363415378234495
37,54,0,1,5,6,0.20658703366702094,0.14129379637870434
37,55,0,0,5,5,0.6607698052553477,0.4519290134511933
37,56,1,0,5,6,1.0096153846153846,0.6905195744500694
37,57,2,0,5,7,3.476147292621531,2.3774872944722394
37,58,0,0,2,2,0.6666666666666666,0.4559621317003633
37,59,2,2,7,11,0.8909428126939014,0.6093542761485431
37,60,0,0,4,4,0.13243642973151593,0.09057899522275106
37,61,1,0,8,9,1.1000029884604674,0.7523395612428074
37,62,1,1,7,9,0.691818779118127,0.4731647479155659
37,63,2,2,8,12,1.0574973933591758,0.723268148615441
37,64,1,0,18,19,1.3563514639230585,0.9276673572378993
37,65,1,0,17,18,1.030748650031139,0.7049735275732048
37,66,1,0,16,17,0.9774466660707146,0.6685179982275243
37,67,1,0,15,16,0.6526857496101325,0.44639997858402836
37,68,1,0,14,15,0.47953681447968777,0.3279759422384401
37,69,1,0,13,14,0.2339494435890204,0.16000813051344542
37,70,0,0,3,3,0.06285771357289609,0.042991105611762837
37,71,0,0,2,2,0.20826024440711244,0.14243817748245846
37,72,0,0,1,1,0.5655166025659881,0.38678123342690257
37,73,1,0,12,13,2.2648968597857007,1.5490608004040203
37,74,1,0,10,11,2.0293321499470394,1.3879479195269
37,75,2,0,4,6,0.03653647603280812,0.024988874245107633
37,76,2,0,5,7,0.6096529324320183,0.4169679760036209
37,77,2,1,8,11,1.5481371113777356,1.0588378462023527
37,78,2,1,4,7,3.640054944640259,2.489590818096931
38,0,3,0,0,3,0.0007498554250817179,0.0005128585171310133
38,1,2,0,6,8,0.40343460628691563,0.27592635462641824
38,2,2,1,5,8,4.975781673268117,3.403152027928397
38,3,2,1,4,7,5.263687936978025,3.6000635585249814
38,4,2,1,5,8,5.517420301278269,3.77360208308655
38,5,2,0,9,11,0.6801855935316007,0.46520830976781824
38,6,2,0,8,10,1.0359559828720066,0.7085350474470976
38,7,2,1,7,10,0.21921388895157753,0.149929848157032
38,8,2,0,3,5,1.0571480423625987,0.7230292123777746
38,9,2,0,2,4,1.4203723320764858,0.9714539945127163
38,10,2,0,1,3,1.3861426896842977,0.9480428634439912
38,11,2,0,1,3,0.04077074438323528,0.027884873279985855
38,12,2,0,2,4,0.0013695025004172683,0.0009366619191888528
38,13,2,0,0,2,0.004513399897399315,0.0030869091576515885
38,14,0,0,12,12,0.1495037378475384,0.10225206450920382
38,15,2,1,1,4,0.22965816967578628,0.15707314291166286
38,16,2,2,5,9,11.95015690273563,8.173228523287722
38,17,2,2,5,9,12.146655493156192,8.307622397534137
38,18,2,0,7,9,0.14052409180200442,0.09611049667994921
38,19,1,0,19,20,0.03964806324872497,0.0271170231550192
38,20,1,0,0,1,0.006141193971703285,0.004200227841784876
38,21,1,0,1,2,0.058297828419842435,0.03987240317972006
38,22,0,0,8,8,0.18752274289848966,0.12825490439144174
38,23,0,0,7,7,0.11059568236905852,0.07564116463477831
38,24,0,0,10,10,0.4860890647558032,0.33245730924343797
38,25,0,0,9,9,0.2609906245876723,0.17850276231120643
38,26,0,1,12,13,0.5637134374007532,0.38554797087808007
38,27,0,0,4,4,0.18158792731682966,0.12419582764564842
38,28,0,0,5,5,0.2973059737272174,0.20334039832187134
38,29,1,0,17,18,0.9153274904491976,0.62603201062374
38,30,0,0,11,11,0.25602557405855125,0.17510694977631938
38,31,1,1,27,29,1.6456880584004714,1.1255571528331663
38,32,2,1,3,6,2.096959227778478,1.4342009993799336
38,33,1,0,15,16,1.0372687841693904,0.7094329289641788
38,34,1,2,25,28,2.7053196373585466,1.8502849631712848
38,35,2,0,3,5,0.7795210863332471,0.5331481443448355
38,36,1,0,18,19,1.4588285559710035,0.9977558672488521
38,37,1,1,21,23,1.865001611089182,1.2755551653252528
38,39,0,0,2,2,1.0486120309046738,0.7171910654069134
38,40,1,1,28,30,2.7681169958939407,1.8932347893657104
38,41,2,0,4,6,1.9608862425943396,1.341134806792846
38,42,2,1,6,9,2.4679565084997677,1.6879420658390094
38,43,0,0,6,6,0.3161669705215117,0.2162402487783516
38,44,1,0,16,17,1.1826493595457053,0.8088649845487936
38,45,1,0,13,14,1.0242350540353145,0.700518597900268
38,46,1,0,12,13,0.261744574389274,0.17901842114930652
38,47,1,0,8,9,0.3130670438370987,0.21412007500964186
38,48,0,1,13,14,0.5591485550066507,0.38242585061701545
38,49,0,0,3,3,0.06844202820263143,0.04681045961575231
38,50,1,0,10,11,0.5380388152898395,0.3679879877356399
38,51,2,1,2,5,2.4058423175562536,1.6454594874718371
38,52,0,0,1,1,0.6600121211008173,0.4514108005278105
38,53,1,1,20,22,2.096689662312221,1.4340166319129926
38,54,1,2,26,29,2.3537712374205686,1.6098458264239264
38,55,1,1,26,28,3.227334346402782,2.2073133724434166
38,56,1,0,14,15,1.2304040924709372,0.8415265092838491
38,57,2,0,5,7,2.16192876848429,1.4786364747936571
38,58,1,1,19,21,3.495926393051818,2.3910150756652033
38,59,2,2,7,11,0.43007203983642234,0.29414484610280806
38,60,1,1,25,27,1.2466949771347728,0.8526685490317599
38,61,1,0,11,12,0.417500152554823,0.285546389316186
38,62,1,1,12,14,0.37662485445298954,0.25759000723158626
38,63,2,2,8,12,0.39102204877779656,0.26743687035385133
38,64,1,0,1,2,1.235561138966826,0.8450536361541641
38,65,1,0,2,3,1.2337768650705052,0.8438332941602085
38,66,1,0,3,4,1.6073862042949272,1.0993608602641058
38,67,1,0,4,5,1.6068474634363876,1.0989923921186653
38,68,1,0,5,6,2.1014946337004856,1.4373029594084215
38,69,1,0,6,7,2.3494838450879123,1.6069134936027756
38,70,1,1,24,26,2.5667944431389675,1.755541598895436
38,71,1,1,23,25,2.771006452861211,1.89521101380309
38,72,1,1,22,24,2.9616559979173815,2.0256044732603637
38,73,1,0,7,8,0.2989040680026154,0.20443340403057428
38,74,1,0,9,10,0.6121649242251067,0.4186860357028065
38,75,2,0,4,6,0.2684159562570394,0.18358126739602673
38,76,2,0,5,7,3.1906629777467534,2.182232239306258
38,77,2,1,8,11,0.5520860630610364,0.377595507293057
38,78,2,1,4,7,10.426990270703437,7.131469066573329
39,0,3,0,0,3,0.00041825226931329826,0.0002860607944569089
39,1,2,0,6,8,0.8804738838342812,0.6021941234693653
39,2,2,1,5,8,2.408874030198382,1.6475330067103495
39,3,2,1,4,7,2.4699874341181496,1.6893311036004328
39,4,2,1,5,8,2.4794387032231255,1.695795234813001
39,5,2,0,9,11,0.1968638462645735,0.13464368849629132
39,6,2,0,8,10,0.4110574255716076,0.28113993002234045
39,7,2,1,7,10,0.30380809273034204,0.20778747838372255
39,8,2,0,3,5,3.041883931257021,2.080475822521549
39,9,2,0,2,4,5.598859010746942,3.8293015344449444
39,10,2,0,1,3,5.401911774124461,3.694600811680621
39,11,2,0,1,3,0.07593506651428696,0.05193527219799472
39,12,2,0,2,4,0.0008686423427522191,0.000594102021429749
39,13,2,0,0,2,0.0008202889619330274,0.000561031055539892
39,14,0,0,10,10,0.07988175075890858,0.0546345800399836
39,15,2,1,1,4,0.326798257065279,0.22351144489117183
39,16,2,2,5,9,5.79846723041721,3.9658222184635985
39,17,2,2,5,9,5.473369035159362,3.7434735192810344
39,18,2,0,7,9,0.19562653809431538,0.13379743998996954
39,19,1,0,19,20,0.016567459414949373,0.011331201167549354
39,20,1,0,0,1,0.0028967395063933107,0.001981205280473628
39,21,1,0,1,2,0.3901757620853422,0.26685805832736964
39,22,0,0,6,6,0.6035512021924843,0.41279473911300313
39,23,0,0,5,5,1.1673728677268744,0.7984167318868679
39,24,0,0,8,8,0.4707331480707274,0.3219547344845275
39,25,0,0,7,7,0.441866543268996,0.3022116164940033
39,26,0,1,10,11,0.2993697082575694,0.2047518755154558
39,27,0,0,2,2,0.6147995735400277,0.42048798617967786
39,28,0,0,3,3,0.4965997665373998,0.3396460322284433
39,29,1,0,17,18,0.22836479876336657,0.15618855067420365
39,30,0,0,9,9,1.8198698409371008,1.2446875981363221
39,31,1,1,27,29,0.7657342657342657,0.5237187421803123
39,32,2,1,3,6,0.724535660808135,0.49554123659251287
39,33,1,0,15,16,0.22782915188574882,0.1558221986359678
39,34,1,2,25,28,1.1430059814415283,0.7817511657665176
39,35,2,0,3,5,0.5543668800845587,0.37915545658115263
39,36,1,0,18,19,0.4559311876596741,0.3118310343509751
39,37,1,1,21,23,0.6783902412762857,0.4639803908055884
39,38,0,0,2,2,1.084771066453111,0.7419217918002552
39,40,1,1,28,30,0.9444444444444444,0.6459463532421813
39,41,2,0,4,6,1.4007178563569767,0.9580114495429355
39,42,2,1,6,9,1.0911321061066257,0.7462723816006259
39,43,0,0,4,4,0.30573681317766543,0.20910661361364605
39,44,1,0,16,17,0.23595609466540915,0.161380565866999
39,45,1,0,13,14,0.47429875054432297,0.3243934040415125
39,46,1,0,12,13,0.2811547616527239,0.1922938866913253
39,47,1,0,8,9,1.5611122094807435,1.0677120762874557
39,48,0,1,11,12,0.299477570434869,0.20482564711789286
39,49,0,0,1,1,1.3589285714285715,0.9294299523856511
39,50,1,0,10,11,1.0175126600268753,0.6959208622469416
39,51,2,1,2,5,0.8992787426290273,0.6150555787229305
39,52,0,0,1,1,0.8500023529379199,0.5813533271938477
39,53,1,1,20,22,0.8502550210846913,0.5815261378540698
39,54,1,2,26,29,0.9352686178373989,0.6396706090523891
39,55,1,1,26,28,1.5142590174408164,1.035667154308218
39,56,1,0,14,15,0.3940243361961198,0.2694902644107051
39,57,2,0,5,7,2.725548752086449,1.8641205285819034
39,58,1,1,19,21,1.6688170959718043,1.1413761007459704
39,59,2,2,7,11,0.5124557067843232,0.3504905947010945
39,60,1,1,25,27,0.5118529711277328,0.3500783577488483
39,61,1,0,11,12,0.6300313591226829,0.43090566231548344
39,62,1,1,12,14,0.3643356911802199,0.24918491760758749
39,63,2,2,8,12,0.638016386386002,0.43636696739448616
39,64,1,0,1,2,0.55930658856548,0.3825339365945615
39,65,1,0,2,3,0.36343347785016394,0.2485678549377563
39,66,1,0,3,4,0.30150458429266014,0.2062120094572698
39,67,1,0,4,5,0.27269010579562314,0.18650454289825488
39,68,1,0,5,6,0.4880844628964523,0.3338220482281399
39,69,1,0,6,7,0.7066733030238461,0.48332439849373443
39,70,1,1,24,26,0.911285819436818,0.6232677372280857
39,71,1,1,23,25,1.10829657988841,0.7580119066832121
39,72,1,1,22,24,1.4022706041353865,0.9590734408234907
39,73,1,0,7,8,1.566929275718533,1.071690619170493
39,74,1,0,9,10,1.197155046631814,0.8187860505571346
39,75,2,0,4,6,0.11930641422199867,0.08159881043128357
39,76,2,0,5,7,1.5367213397633885,1.0510301068619292
39,77,2,1,8,11,0.929234720249065,0.6355437658421316
39,78,2,1,4,7,3.4568382769145063,2.3642810245280237
40,0,3,0,0,3,0.0006124817843924677,0.0004189027500588478
40,1,2,0,6,8,1.4316837253346804,0.9791903449864773
40,2,2,1,5,8,1.1771294238763874,0.8050896620968472
40,3,2,1,4,7,1.1566683437718568,0.7910954455448165
40,4,2,1,5,8,1.1016873014534254,0.7534915356568868
40,5,2,0,9,11,0.4523630924021006,0.3093906598713453
40,6,2,0,8,10,0.9386107576233043,0.6419564428242223
40,7,2,1,7,10,0.5288864195758423,0.36172826894576066
40,8,2,0,3,5,4.766543613199078,3.260045080075505
40,9,2,0,2,4,8.254420930142544,5.645555044889835
40,10,2,0,1,3,7.7693958362158355,5.3138254312573485
40,11,2,0,1,3,0.10171463063331145,0.06956702971301963
40,12,2,0,2,4,0.0011296274684191756,0.0007726010227915381
40,13,2,0,0,2,0.0032873820669664924,0.0022483826024513823
40,14,1,1,19,21,0.19440630193598743,0.13296286777007593
40,15,2,1,1,4,0.40894245167002824,0.27969340800935827
40,16,2,2,5,9,2.860082069529552,1.9561336758910217
40,17,2,2,5,9,2.4652963210156345,1.6861226487050278
40,18,2,0,7,9,0.3416728415342091,0.23368481575508765
40,19,1,0,0,1,0.005037653085780555,0.003445468559639122
40,20,1,0,19,20,0.007457102451638924,0.005100234495235933
40,21,1,0,20,21,0.5644541594201735,0.3860545826645385
40,22,1,1,23,25,0.9958940294356241,0.6811349469136972
40,23,1,1,24,26,1.7580282855258351,1.202391486986842
40,24,1,1,21,23,0.9469932523985592,0.6476895931042608
40,25,1,1,22,24,0.792875200981228,0.542281600217632
40,26,1,2,19,22,0.7242578150880039,0.49535120590226067
40,27,1,1,27,29,1.0211744753115295,0.6984253359015674
40,28,1,1,26,28,0.9026064207030906,0.6173315215053241
40,29,1,0,2,3,0.25341444155905707,0.17332108346538716
40,30,1,1,20,22,2.7490109898991815,1.8801673665332348
40,31,0,0,1,1,0.31002331002331,0.21203833397254657
40,32,2,1,3,6,0.40593141954822015,0.2776340330720414
40,33,1,0,4,5,0.6600943037141878,0.4514670087671821
40,34,0,1,3,4,0.3704000277477791,0.2533325793506266
40,35,2,0,3,5,0.48805700317715106,0.33380326733991716
40,36,1,0,1,2,0.251429293864565,0.17196335520360617
40,37,0,0,7,7,0.25,0.1709857993876362
40,38,1,1,31,33,1.6465523510058786,1.1261482798813276
40,39,1,1,29,31,0.5430555555555555,0.3714191531142543
40,41,2,0,4,6,1.2603789361083968,0.8620275996873309
40,42,2,1,6,9,0.4346647794652157,0.297286019130042
40,43,1,1,25,27,0.6238348317156849,0.4266675895470316
40,44,1,0,3,4,0.5187532733040323,0.3547977724833716
40,45,1,0,6,7,1.126148798499607,0.7702218101635255
40,46,1,0,7,8,0.5325264729987086,0.3642178587230507
40,47,1,0,11,12,2.2769563408916023,1.5573088004723907
40,48,1,2,20,23,0.7364770159459412,0.5037084452085506
40,49,1,1,28,30,2.056536679041952,1.406554272143931
40,50,1,0,9,10,1.740204655129832,1.1902011362218405
40,51,2,1,2,5,0.41916956592768045,0.2866881732364517
40,52,1,1,30,32,1.6320012254897358,1.1161961365678579
40,53,0,0,8,8,0.30028687059263703,0.20537916245557486
40,54,0,1,4,5,0.2558781513313358,0.175006121004876
40,55,0,0,2,2,0.6329208820818023,0.43288193188753926
40,56,1,0,5,6,1.05269799891663,0.7199856354341
40,57,2,0,5,7,3.263743249705773,2.232214994187773
40,58,0,0,9,9,0.7673134589281037,0.5247988206228559
40,59,2,2,7,11,0.9172239240441928,0.6273290634806433
40,60,0,0,3,3,0.15280599858190902,0.10451062327501487
40,61,1,0,8,9,1.117352375645636,0.764205556589774
40,62,1,1,7,9,0.7058416229539137,0.4827555765673659
40,63,2,2,8,12,1.083253529242707,0.7408838825481697
40,64,1,0,18,19,1.3842489548506445,0.9467476563865497
40,65,1,0,17,18,1.058763103381503,0.7241338223752833
40,66,1,0,16,17,1.0158040462272397,0.6947522674614399
40,67,1,0,15,16,0.6960856393326588,0.476083037934194
40,68,1,0,14,15,0.5535444261847499,0.3785929448310794
40,69,1,0,13,14,0.3621991406319041,0.24772363839384398
40,70,0,0,4,4,0.2835612235029497,0.19393976990395217
40,71,0,0,5,5,0.3461621075730094,0.2367552187243198
40,72,0,0,6,6,0.6216193290734915,0.4251523115857482
40,73,1,0,12,13,2.2790744828737295,1.5587574892725133
40,74,1,0,10,11,2.0526031296333476,1.4038639477836876
40,75,2,0,4,6,0.04837706189964385,0.03308716240374305
40,76,2,0,5,7,0.7374927036131632,0.5044031178793832
40,77,2,1,8,11,1.582017377720768,1.0820100238988704
40,78,2,1,4,7,2.218547519203381,1.5173604842017894
41,0,1,0,0,1,0.0008602583876544174,0.0005883678723720384
41,1,0,0,10,10,2.4856213333237194,1.7000238026132735
41,2,0,1,9,10,4.454507920960657,3.046630390976062
41,3,0,1,8,9,4.851539343247844,3.318177331463201
41,4,0,1,9,10,5.285396965015516,3.6149113005766575
41,5,0,0,13,13,1.3150632436798184,0.8994285598635664
41,6,0,0,12,12,2.3713331983566976,1.6218572101418403
41,7,0,1,11,12,0.9892294169211264,0.6765767305200963
41,8,0,0,7,7,7.940820627076583,5.431070250858081
41,9,0,0,6,6,12.83348552398936,8.777375124995913
41,10,0,0,5,5,11.727371625262267,8.020856048245406
41,11,0,0,3,3,0.11285171766510996,0.07718416462894662
41,12,0,0,2,2,0.001285903504189218,0.0008794849543966242
41,13,0,0,4,4,0.008926429472407996,0.006105170716068148
41,14,0,2,23,25,0.41888239522099413,0.2864917647850778
41,15,0,1,3,4,0.3883734175183054,0.2656253570211026
41,16,0,2,9,11,10.74893082538393,7.351658118962702
41,17,0,2,9,11,11.682415973385242,7.990108935952663
41,18,0,0,11,11,0.6382417697933582,0.4365211168427882
41,19,0,1,4,5,0.03561154307965877,0.024356272643610795
41,20,0,1,23,24,0.016339876112575497,0.01117554711601465
41,21,0,1,24,25,0.8132198537986175,0.5561961871186131
41,22,0,2,27,29,1.6485622134747495,1.1275229116449241
41,23,0,2,28,30,2.651411686293021,1.813414986746131
41,24,0,2,25,27,1.834965810992415,1.255012384166081
41,25,0,2,26,28,1.409066309260902,0.9637213171166462
41,26,0,3,23,26,1.5737605352219954,1.0763628126385887
41,27,0,2,31,33,1.670563153550323,1.1425703049493299
41,28,0,2,30,32,1.5883486904644082,1.086340282181448
41,29,0,1,6,7,1.243974662113199,0.85080800807756
41,30,0,2,24,26,4.217079773805528,2.8842430248222812
41,31,0,2,12,14,1.2611961298815764,0.8625865138095776
41,32,0,1,3,4,1.7373799696659598,1.1882692118136051
41,33,0,1,8,9,1.95318107878676,1.3358649124206394
41,34,0,3,10,13,2.44596109830971,1.6728984546621857
41,35,0,0,1,1,0.045209491508965576,0.03092072418227613
41,36,0,1,5,6,1.7327155776849987,1.1850790326475176
41,37,0,2,6,8,2.003992503013221,1.3706170403781823
41,38,0,2,35,37,2.4342036114964216,1.6648570015359467
41,39,0,2,33,35,1.680861427628372,1.1496137394515225
41,40,0,2,13,15,2.6303560405740454,1.7990141210866035
41,42,0,1,10,11,2.2779953223425506,1.5580194047681484
41,43,0,2,29,31,1.1895057296088793,0.8135543522133909
41,44,0,1,7,8,1.8879035128592467,1.2912187652518594
41,45,0,1,10,11,2.625245035122234,1.7955184836751932
41,46,0,1,11,12,1.0340696301506973,0.7072448893351772
41,47,0,1,15,16,3.4247049876450015,2.3423036799172214
41,48,0,3,24,27,1.5658227999699617,1.0709338526090029
41,49,0,2,32,34,3.075785945685016,2.1036628746728363
41,50,0,1,13,14,3.083917863028213,2.109224644222759
41,51,0,1,2,3,1.8590478820562362,1.2714831528531105
41,52,0,2,34,36,2.90675420357484,1.9880547644864635
41,53,0,2,5,7,2.075834717750848,1.4197530344449478
41,54,0,3,11,14,2.2291023007622472,1.5245793552506077
41,55,0,2,11,13,2.5852889603029796,1.7681907981017435
41,56,0,1,9,10,2.711756674252878,1.8546875307675448
41,57,0,0,1,1,2.774,1.8972584300052115
41,58,0,2,4,6,3.031838968315473,2.0736056384480297
41,59,0,2,11,13,1.7640591329373987,1.2065162440494461
41,60,0,2,10,12,1.15161530071714,0.787639451120613
41,61,0,1,12,13,2.0477778562594273,1.400563734883273
41,62,0,2,11,13,1.3981821137249952,0.9562771456190529
41,63,0,2,12,14,1.969403146345224,1.3469598851774562
41,64,0,1,22,23,3.187700073752875,2.180205781274649
41,65,0,1,21,22,2.708414712319044,1.8524018186364264
41,66,0,1,20,21,3.0007339929046473,2.0523316021058187
41,67,0,1,19,20,2.5418044089426535,1.7384498350003112
41,68,0,1,18,19,2.814175379680883,1.9247361076469618
41,69,0,1,17,18,2.750394944969963,1.8811139131896117
41,70,0,2,9,11,2.7123171903035836,1.855070891907543
41,71,0,2,8,10,2.692301122020464,1.8413810381635962
41,72,0,2,7,9,2.5185914617874987,1.7225734976984426
41,73,0,1,16,17,3.3990481705345377,2.3247558743837216
41,74,0,1,14,15,3.6154899223793353,2.4727897382238937
41,75,0,0,8,8,0.24792824761263463,0.16956883843528858
41,76,0,0,9,9,2.8365398335015173,1.9400321237045177
41,77,0,1,12,13,2.8603862350354445,1.9563417078197065
41,78,0,1,4,5,8.957555088107371,6.126458869195308
42,0,2,0,0,2,0.0008343203745378831,0.000570627744743008
42,1,1,0,2,3,1.6624266370128788,1.1370053898117876
42,2,1,1,1,3,0.3695756085041795,0.25276872341703693
42,3,0,0,2,2,0.2678970410619231,0.18322635887822128
42,4,0,0,1,1,0.20315286864928686,0.1389450225755591
42,5,1,0,5,6,0.5772367339295337,0.39479713754739837
42,6,1,0,4,5,1.1701404103190767,0.8003095738167358
42,7,1,1,3,5,0.6226472705375053,0.4258553651575406
42,8,1,0,1,2,5.490882751291431,3.7554519062933944
42,9,1,0,2,3,9.374747938998313,6.411795081628887
42,10,1,0,3,4,8.771083641471803,5.998922991731502
42,11,1,0,5,6,0.11837176060574477,0.0809595604483807
42,12,1,0,6,7,0.0014941277663527196,0.0010218985220683324
42,13,1,0,4,5,0.004465557033142501,0.0030541873560918065
42,14,1,2,23,26,0.24725140118002878,0.16910591392192148
42,15,1,1,5,7,0.4716384634577012,0.32257391878508596
42,16,1,2,1,4,0.9147707666708396,0.6256512431826174
42,17,0,1,1,2,0.5013205701440814,0.34287479374220525
42,18,1,0,3,4,0.4027748810035168,0.2754751400065856
42,19,1,1,4,6,0.0024456306054391848,0.001672672416311551
42,20,1,1,23,25,0.00958718148252782,0.006557087558657451
42,21,1,1,24,26,0.6446708356116827,0.44091823267583596
42,22,1,2,27,30,1.1735552458707272,0.8026451273630409
42,23,1,2,28,31,2.027868282318057,1.3869467172199432
42,24,1,2,25,28,1.1632650128052358,0.7956071924566886
42,25,1,2,26,29,0.9520599750119442,0.6511549435695608
42,26,1,3,23,27,0.9184877533676863,0.6281934509493117
42,27,1,2,31,34,1.2098827171408437,0.8274910542224501
42,28,1,2,30,33,1.0916413204754778,0.7466206553042974
42,29,1,1,6,8,0.37717725536670677,0.25796781807884384
42,30,1,2,24,27,3.164511156215132,2.164345878866149
42,31,1,2,12,15,0.20571343197331543,0.14069630244292586
42,32,1,1,7,9,0.8264524126505703,0.5652465057315934
42,33,1,1,8,10,0.8771428571428571,0.5999158904229065
42,34,1,3,10,14,0.1313822085452297,0.08985796781367691
42,35,1,0,7,8,0.5425408458410953,0.371067120906336
42,36,1,1,5,7,0.38016778455682854,0.26001317017550396
42,37,1,2,6,9,0.28711489612976293,0.19637028012338262
42,38,1,2,35,38,1.9147938428015439,1.3096102234957834
42,39,1,2,33,36,0.8183490795799693,0.5597042862004695
42,40,1,2,13,16,0.5669540601720204,0.3877643727783157
42,41,1,0,8,9,1.4237470764640943,0.9737621279800928
42,43,1,2,29,32,0.7726598794638961,0.5284554685795557
42,44,1,1,7,9,0.7236481257136965,0.4949342130020843
42,45,1,1,10,12,1.4130481233665753,0.9664446517881322
42,46,1,1,11,13,0.6413333333333333,0.4386355706957495
42,47,1,1,15,17,2.588888888888889,1.7706529447697439
42,48,1,3,24,28,0.9417161976755695,0.6440803874233699
42,49,1,2,32,35,2.3819293382569056,1.6291043679468813
42,50,1,1,13,15,2.053030303030303,1.4041561101227094
42,51,1,1,6,8,0.8340751906219913,0.570460052871585
42,52,1,2,34,37,2.011717674028838,1.3759006185442284
42,53,1,2,5,8,0.14815771318984378,0.1013314601008383
42,54,1,3,11,15,0.19174674934958888,0.13114388487008066
42,55,1,2,11,14,0.3102002152702654,0.21215932711281268
42,56,1,1,9,11,1.3519285479701095,0.9246423339585419
42,57,1,0,9,10,3.7331573768058584,2.553267593252003
42,58,1,2,4,7,0.23044429948123843,0.1576108110444936
42,59,1,2,3,6,1.0859277345689553,0.7427128870899107
42,60,1,2,10,13,0.07764309754205227,0.053103468400640085
42,61,1,1,12,14,1.3282051282051281,0.9084168623876469
42,62,1,2,11,14,0.8536368477101928,0.5838391151698769
42,63,1,2,4,7,1.2692536462796176,0.8680973973391699
42,64,1,1,22,24,1.7531929804201216,1.1990844129517078
42,65,1,1,21,23,1.3778891986654183,0.9423979444055842
42,66,1,1,20,22,1.3739940806776592,0.9397339049541996
42,67,1,1,19,21,0.9993379308566388,0.6834903798636349
42,68,1,1,18,20,0.874695305003055,0.5982419037862386
42,69,1,1,17,19,0.6254661845559352,0.4277833422249256
42,70,1,2,9,12,0.4081648846029741,0.2791615963032073
42,71,1,2,8,11,0.2069643049734984,0.14155182852240064
42,72,1,2,7,10,0.19917364004528534,0.1362234562403537
42,73,1,1,16,18,2.592039525428593,1.7728078011990287
42,74,1,1,14,16,2.4265405193197394,1.6596158817695024
42,75,1,0,0,1,0.0012852517538002506,0.0008790391941515891
42,76,1,0,1,2,0.2225996000704642,0.15224548224566578
42,77,1,1,4,6,1.8570749728183324,1.2701337950004614
42,78,1,1,8,10,4.4326846053444315,3.0317044827123456
43,0,3,0,0,3,0.0005269296479955144,0.00036038994833423527
43,1,2,0,6,8,0.36441946404489467,0.2492422134885211
43,2,2,1,5,8,3.632297956558086,2.484285478864648
43,3,2,1,4,7,3.7982622833105,2.597795651183017
43,4,2,1,5,8,3.9191007200892334,2.680442278020473
43,5,2,0,9,11,0.3306487343710066,0.22614495265174706
43,6,2,0,8,10,0.43820946378890263,0.29971038186069177
43,7,2,1,7,10,0.10849161990040247,0.0742021054221196
43,8,2,0,3,5,1.3987745522184354,0.9566823398966083
43,9,2,0,2,4,3.037398705317056,2.0774081827504327
43,10,2,0,1,3,3.113614757839306,2.1295356334171807
43,11,2,0,1,3,0.05716895836708312,0.03910032018621681
43,12,2,0,2,4,0.0010450703849348886,0.0007147687807377464
43,13,2,0,0,2,0.0019061840556761672,0.0013037216181590238
43,14,0,0,6,6,0.03444418156947455,0.02355786367963797
43,15,2,1,1,4,0.2757499837392566,0.1885973256031379
43,16,2,2,5,9,8.726181868377488,5.968212729465686
43,17,2,2,5,9,8.630988758082632,5.903106049225841
43,18,2,0,7,9,0.06814621185309534,0.04660813803576287
43,19,1,0,19,20,0.027791155836638597,0.01900757198653609
43,20,1,0,0,1,0.0015750143034936731,0.001077220318919307
43,21,1,0,1,2,0.2237052635986348,0.1530016932945378
43,22,0,0,2,2,0.2256869480283609,0.15435705287994078
43,23,0,0,1,1,0.601100918356965,0.4111188841516316
43,24,0,0,4,4,0.04814814814814815,0.032930598400581795
43,25,0,0,3,3,0.104559749824413,0.07151292962999405
43,26,0,1,6,7,0.13562839573037447,0.09276211865448299
43,27,0,0,2,2,0.22605126707723233,0.1546062264151545
43,28,0,0,1,1,0.1073118912976977,0.07339523806934387
43,29,1,0,17,18,0.5415213072630977,0.3703698144312741
43,30,0,0,5,5,0.9247115542313072,0.6324501772128943
43,31,1,1,27,29,1.1994955000014464,0.820386787718479
43,32,2,1,3,6,1.4088797802298152,0.9635937418546887
43,33,1,0,15,16,0.4888386904758281,0.33433789705045897
43,34,1,2,25,28,1.9005493083872125,1.2998677710808266
43,35,2,0,3,5,0.6694275702239422,0.457850432907455
43,36,1,0,18,19,0.9259651477753092,0.6333075639898078
43,37,1,1,21,23,1.2408667374644553,0.8486823641555521
43,38,0,0,6,6,0.5560177757447275,0.3802845754377907
43,39,0,0,4,4,0.5197525824020311,0.35548124314319823
43,40,1,1,28,30,1.8443812415941987,1.2614520038781805
43,41,2,0,4,6,1.6851331169459125,1.1525353323023038
43,42,2,1,6,9,1.751362393451498,1.1978323954469927
43,44,1,0,16,17,0.6333010361212538,0.4331419356568435
43,45,1,0,13,14,0.3476939664531418,0.2378029231849937
43,46,1,0,12,13,0.07086763875156434,0.04846943945060181
43,47,1,0,8,9,0.869739724244368,0.5948525680364222
43,48,0,1,7,8,0.12389434720247808,0.08473669598410026
43,49,0,0,3,3,0.694872345492762,0.4752532138657666
43,50,1,0,10,11,0.33641823198749266,0.2300909612998267
43,51,2,1,2,5,1.6529500668837858,1.1305239541358834
43,52,0,0,5,5,0.14718695594379277,0.10066751728592882
43,53,1,1,20,22,1.4451947616823002,0.9884311263882901
43,54,1,2,26,29,1.6219752699718846,1.1093389524924788
43,55,1,1,26,28,2.3523122526323537,1.608847963702697
43,56,1,0,14,15,0.49927832533953054,0.3414780143003998
43,57,2,0,5,7,2.4357109844971343,1.6658879590459557
43,58,1,1,19,21,2.547595756172952,1.7424107875431272
43,59,2,2,7,11,0.17929224270687216,0.12262570977294651
43,60,1,1,25,27,0.8679433414590398,0.5936239442502002
43,61,1,0,11,12,0.1814544206456834,0.12410451666609032
43,62,1,1,12,14,0.09545887436071555,0.06528844776484352
43,63,2,2,8,12,0.23612578319092634,0.16149662317972888
43,64,1,0,1,2,0.38732020392680006,0.26490501874962474
43,65,1,0,2,3,0.4836065287588694,0.33075939563566065
43,66,1,0,3,4,0.7460467933855881,0.5102536293904698
43,67,1,0,4,5,0.8516274523680839,0.5824648028944517
43,68,1,0,5,6,1.2377529020334983,0.8465526775942571
43,69,1,0,6,7,1.4856834995307922,1.0161231232171737
43,70,1,1,24,26,1.7031191490257107,1.1648367565942077
43,71,1,1,23,25,1.9075159417213055,1.3046325525595086
43,72,1,1,22,24,2.156132243161351,1.4746719807296034
43,73,1,0,7,8,0.879668096618044,0.6016430107841467
43,74,1,0,9,10,0.3847388148809793,0.26313949527150415
43,75,2,0,4,6,0.19074108115319632,0.13045606494816506
43,76,2,0,5,7,2.326883400605358,1.591456073337314
43,77,2,1,8,11,0.33306648027907854,0.22779855351897849
43,78,2,1,4,7,6.922714175047536,4.734743268610494
44,0,2,0,0,2,0.0005731867003841899,0.00039202714465420905
44,1,1,0,6,7,0.9209191864715134,0.6298564130809734
44,2,1,1,5,7,2.1001003521730888,1.4363493500422881
44,3,1,1,4,6,2.125216053403876,1.4535270630507964
44,4,1,1,5,7,2.0920684075764284,1.4308559561722989
44,5,1,0,9,10,0.11454804482696201,0.07834435605211557
44,6,1,0,8,9,0.3520182814388979,0.24076050900356744
44,7,1,1,7,9,0.3155172702754271,0.21579589071459512
44,8,1,0,3,4,3.1847551380374903,2.178191612524888
44,9,1,0,2,3,5.850590379885596,4.001471491977412
44,10,1,0,1,2,5.638083862069298,3.8561291046818007
44,11,1,0,1,2,0.0860527574914438,0.058855198116739685
44,12,1,0,2,3,0.0011225249903416385,0.0007677433312246547
44,13,1,0,0,1,0.0011270594377714067,0.0007708446356988952
44,14,0,1,16,17,0.09788047529160582,0.06694468524870799
44,15,1,1,1,3,0.3678207250689726,0.251568482829033
44,16,1,2,5,8,5.04510901765264,3.450567993524435
44,17,1,2,5,8,4.608041838653037,3.1516388695750504
44,18,1,0,7,8,0.20393665102595004,0.1394810852004379
44,19,0,0,3,3,0.014668508324548593,0.010032426486788551
44,20,0,0,16,16,0.0036990490326235764,0.0025299394232688186
44,21,0,0,17,17,0.4186714630890217,0.2863474991882704
44,22,0,1,20,21,0.6619514918585175,0.45273721996506794
44,23,0,1,21,22,1.2605341252785405,0.8621337402645841
44,24,0,1,18,19,0.5395217106557079,0.36900220393380473
44,25,0,1,19,20,0.4937799015323729,0.33771740474024425
44,26,0,2,16,18,0.35891640761369625,0.24547843547666617
44,27,0,1,24,25,0.6845026200136531,0.46816091066386356
44,28,0,1,23,24,0.5675257733990785,0.3881553921509117
44,29,0,0,1,1,0.11411992263056092,0.07805154478816663
44,30,0,1,17,18,1.9504754025411686,1.334014383557693
44,31,0,1,11,12,0.7174528302889415,0.490696982839507
44,32,1,1,3,5,0.841421531647273,0.5754845328427128
44,33,0,0,1,1,0.15143530982312048,0.10357315002248246
44,34,0,2,9,11,1.0049573304927484,0.68733373001907
44,35,1,0,3,4,0.6010630075097073,0.41109295528553647
44,36,0,0,2,2,0.31955922865013775,0.2185603606497609
44,37,0,1,5,6,0.5322605083032852,0.3640359539788272
44,38,0,1,28,29,1.1928446126452372,0.8158379585535246
44,39,0,1,26,27,0.23005719229877392,0.157346051720324
44,40,0,1,12,13,0.8796251156024896,0.6016136142109344
44,41,1,0,4,5,1.5339216041981378,1.0491152467671359
44,42,1,1,6,8,0.9407425634278055,0.6434144769027096
44,43,0,1,22,23,0.36321677071660147,0.24841963956789553
44,45,0,0,3,3,0.4927569533135554,0.3370177662645376
44,46,0,0,4,4,0.30266740088016675,0.20700730995229386
44,47,0,0,8,8,1.6481491885140285,1.1272404260326205
44,48,0,2,17,19,0.3807122493653399,0.260385553177591
44,49,0,1,25,26,1.4803840683403473,1.0124986133035814
44,50,0,0,6,6,1.0909107349524647,0.7461209763056037
44,51,1,1,2,4,0.9971008321350677,0.6819603314107673
44,52,0,1,27,28,1.0202372273152944,0.6977843115101247
44,53,0,1,4,5,0.7070707070707071,0.4835962002882641
44,54,0,2,10,12,0.8081264290310267,0.5527125738965839
44,55,0,1,10,11,1.3888018797355601,0.9498615983905463
44,56,0,0,2,2,0.3750049309340507,0.2564820715602559
44,57,1,0,5,6,3.045112149002069,2.0826837400884863
44,58,0,1,3,4,1.4754922317750272,1.009152874961202
44,59,1,2,7,10,0.5303686246022195,0.36274201299092657
44,60,0,1,9,10,0.446646912059501,0.30548111721005217
44,61,0,0,5,5,0.6769242909857023,0.46297776407639674
44,62,0,1,4,5,0.39181818181818184,0.267981380131168
44,63,1,2,8,11,0.665656121854489,0.4552709764502543
44,64,0,0,15,15,0.6212338698476753,0.4248886793703181
44,65,0,0,14,14,0.3883625889401311,0.26561795088872114
44,66,0,0,13,13,0.24632583909346992,0.16847288202890884
44,67,0,0,12,12,0.05305889729377392,0.03628927187360969
44,68,0,0,11,11,0.2680245012882523,0.1833135344329774
44,69,0,0,10,10,0.5147013604350327,0.3520264942395518
44,70,0,1,8,9,0.732394610461924,0.5009163117481141
44,71,0,1,7,8,0.9372076499950178,0.6409967969064244
44,72,0,1,6,7,1.2512649849252555,0.8557941747728135
44,73,0,0,9,9,1.6583174893683603,1.134194966232588
44,74,0,0,7,7,1.2928443480523153,0.8842320973420502
44,75,1,0,4,5,0.1027731081416276,0.07029096820459271
44,76,1,0,5,6,1.3437907860445253,0.9190765670462527
44,77,1,1,8,10,0.9760743378657813,0.6675794036869535
44,78,1,1,4,6,4.144636106859718,2.8346956716090776
45,0,2,0,0,2,0.0005672876480820054,0.000387992527960135
45,1,1,0,6,7,0.5251774564474144,0.3591915488441066
45,2,1,1,5,7,3.0423899602984315,2.0808219176421847
45,3,1,1,4,6,3.1527578042514044,2.15630725374214
45,4,1,1,5,7,3.2124876934426467,2.1971591051449386
45,5,1,0,9,10,0.15578064347656964,0.1065451114158465
45,6,1,0,8,9,0.12701819897414643,0.08687323315348905
45,7,1,1,7,9,0.1522611935930497,0.10413800760889294
45,8,1,0,3,4,1.9526311979074087,1.335488825133744
45,9,1,0,2,3,3.9660135044253133,2.712527957745291
45,10,1,0,1,2,3.9621792617652276,2.7099055535601675
45,11,1,0,1,2,0.07093499910161136,0.048515510103801104
45,12,1,0,2,3,0.0011234688241644486,0.0007683888599473839
45,13,1,0,0,1,0.000952079462200636,0.0006511682716997061
45,14,0,1,13,14,0.027871511353436084,0.019062530595635393
45,15,1,1,1,3,0.32253236645889327,0.2205938180294396
45,16,1,2,5,8,7.305030610628694,4.9962259940379985
45,17,1,2,5,8,7.0709801534566985,4.836148775971616
45,18,1,0,7,8,0.0980713672770232,0.06707524452360113
45,19,0,0,6,6,0.022966904421991324,0.015708058048214495
45,20,0,0,13,13,0.0011655849148020949,0.0007971938736464243
45,21,0,0,14,14,0.298185212975501,0.20394174802475437
45,22,0,1,17,18,0.38975896370813295,0.2665729919125272
45,23,0,1,18,19,0.8515367192351091,0.5824027465853612
45,24,0,1,15,16,0.21415038439402181,0.14646669865912562
45,25,0,1,16,17,0.2513240118386942,0.17189134827818747
45,26,0,2,13,15,0.08999314102807372,0.06155019663235787
45,27,0,1,21,22,0.4073769092383067,0.2786226659127056
45,28,0,1,20,21,0.29460020284088206,0.201489804730032
45,29,0,0,4,4,0.37717725536670677,0.25796781807884384
45,30,0,1,14,15,1.3015167614594452,0.8901635354982026
45,31,0,1,14,15,1.0276581404502674,0.7028597945684029
45,32,1,1,3,5,1.2252287095484824,0.8379868413393169
45,33,0,0,2,2,0.237160068222253,0.16220401539123308
45,34,0,2,12,14,1.569242397269743,1.0732726629205505
45,35,1,0,3,4,0.6619250817040083,0.4527191569195452
45,36,0,0,5,5,0.6942162425103522,0.4748044766940547
45,37,0,1,8,9,0.9709677419354839,0.6640867821377872
45,38,0,1,25,26,0.8123243532004218,0.5555837155760747
45,39,0,1,23,24,0.36362904208398095,0.2487016097651596
45,40,0,1,15,16,1.5015317313328094,1.0269624135513675
45,41,1,0,4,5,1.6772398835503164,1.147136809014707
45,42,1,1,6,8,1.4444491927747214,0.9879211996056463
45,43,0,1,19,20,0.15680316134161296,0.10724445555401677
45,44,0,0,3,3,0.38746700602433415,0.2650054230456193
45,46,0,0,1,1,0.12134065911950355,0.08299011839108394
45,47,0,0,5,5,1.144450437476817,0.7827390916460141
45,48,0,2,14,16,0.1299492949256906,0.08887793629091563
45,49,0,1,22,23,1.002002141123624,0.6853125483525837
45,50,0,0,3,3,0.5757700357503438,0.3937939993048817
45,51,1,1,2,4,1.4409454482117712,0.9855248373458619
45,52,0,1,24,25,0.529648940336899,0.3622497898332765
45,53,0,1,7,8,1.1649843813854805,0.7967831429012292
45,54,0,2,13,15,1.3207073724819556,0.903288823363887
45,55,0,1,13,14,2.00158124475097,1.368967876692178
45,56,0,0,1,1,0.14807692307692308,0.10127620425267685
45,57,1,0,5,6,2.7620282402611305,1.8890704263691025
45,58,0,1,6,7,2.142156862745098,1.465113614360726
45,59,1,2,7,10,0.23563338822034155,0.1611598529890893
45,60,0,1,12,13,0.7120779303238423,0.4870208565708628
45,61,0,0,2,2,0.32821514407794145,0.22448051512518008
45,62,0,1,1,2,0.14454831329362877,0.09886283559458241
45,63,1,2,8,11,0.34406409583218117,0.2353202978657991
45,64,0,0,12,12,0.06348867255949953,0.04342264571858365
45,65,0,0,11,11,0.1563598246845737,0.10694123846320996
45,66,0,0,10,10,0.3735689638166437,0.2554999516183991
45,67,0,0,9,9,0.5282291467669505,0.36127873167918423
45,68,0,0,8,8,0.8705500227761828,0.5954067662052421
45,69,0,0,7,7,1.1200487167395434,0.7660497007392278
45,70,0,1,11,12,1.3385135422811,0.9154672320724421
45,71,0,1,10,11,1.5436764756720778,1.055787024754717
45,72,0,1,9,10,1.8176029697256648,1.2431371869915373
45,73,0,0,6,6,1.1584616578159839,0.7923219704863692
45,74,0,0,4,4,0.6861978914549686,0.469320380034153
45,75,1,0,4,5,0.15736767157264303,0.10763054848647748
45,76,1,0,5,6,1.950138022080954,1.3337836344869427
45,77,1,1,8,10,0.5056138597713686,0.3458111599779027
45,78,1,1,4,6,6.02322335057813,4.1195426379555125
46,0,2,0,0,2,0.0006231751064907233,0.0004262163749671666
46,1,1,0,6,7,0.2646804557341136,0.1810263972239251
46,2,1,1,5,7,3.673921235071915,2.512753437063933
46,3,1,1,4,6,3.8416075809801633,2.6274413726699866
46,4,1,1,5,7,3.96385253306679,2.7110499760845275
46,5,1,0,9,10,0.3210411504080659,0.21957391095539802
46,6,1,0,8,9,0.40307496811477717,0.27568038254500465
46,7,1,1,7,9,0.050361411904344795,0.03444434509101765
46,8,1,0,3,4,1.135690709845666,0.7767479355202926
46,9,1,0,2,3,2.71073611363736,1.8539895252768734
46,10,1,0,1,2,2.8446343922346013,1.9455683420871843
46,11,1,0,1,2,0.06225438415924353,0.04257846256341301
46,12,1,0,2,3,0.001207205653070992,0.0008256600944624681
46,13,1,0,0,1,0.002096688807987096,0.0014340160476031347
46,14,0,1,12,13,0.04655241419704993,0.03183920701962771
46,15,1,1,1,3,0.297813189243463,0.20368730492389964
46,16,1,2,5,8,8.820249744511521,6.032549813455586
46,17,1,2,5,8,8.723431919996276,5.966331920976742
46,18,1,0,7,8,0.0311388353429103,0.02129719461242999
46,19,0,0,7,7,0.02853204096766733,0.019514295332069536
46,20,0,0,12,12,0.0021333086524595703,0.0014590619411254425
46,21,0,0,13,13,0.21791796940662356,0.14904351279968794
46,22,0,1,16,17,0.21050126986271347,0.1439709115983544
46,23,0,1,17,18,0.5794855385942371,0.3963351922004422
46,24,0,1,14,15,0.08471870846566797,0.05794278436036136
46,25,0,1,15,16,0.09891453653913747,0.06765192440480788
46,26,0,2,12,14,0.1699673171197595,0.11624799034997578
46,27,0,1,20,21,0.22923531168866634,0.15678393206784225
46,28,0,1,19,20,0.13567683341307754,0.09279524727807287
46,29,0,0,5,5,0.5531923347439132,0.37835213428520337
46,30,0,1,13,14,0.8679464083096523,0.5936260418018144
46,31,0,1,15,16,1.2366999906361502,0.8458325460064176
46,32,1,1,3,5,1.5258533502407405,1.0435970193568636
46,33,0,0,3,3,0.49714285714285716,0.3400174753536994
46,34,0,2,13,15,1.9472481027365545,1.331807093809871
46,35,1,0,3,4,0.7100740384235226,0.48565030833701256
46,36,0,0,6,6,0.9449045852101744,0.646261063388818
46,37,0,1,9,10,1.2645202435746095,0.8648600187578123
46,38,0,1,24,25,0.5641046861837802,0.3858155628217813
46,39,0,1,22,23,0.5857390867765082,0.40061226394026106
46,40,0,1,16,17,1.9294437427489444,1.319629922909604
46,41,1,0,4,5,1.7952597745671828,1.2278557106513495
46,42,1,1,6,8,1.7814814814814814,1.2184321408215262
46,43,0,1,18,19,0.08684759650927001,0.05939882285612968
46,44,0,0,4,4,0.6467252155559119,0.4423233118638758
46,45,0,0,1,1,0.3297300519551727,0.2255166260627281
46,47,0,0,4,4,0.8074074074074075,0.5522208039482177
46,48,0,2,13,15,0.18785728073591682,0.1284837092696733
46,49,0,1,21,22,0.686246538224048,0.4693536516609476
46,50,0,0,2,2,0.23106060606060605,0.15803232973705772
46,51,1,1,2,4,1.7750452361215412,1.214030114589829
46,52,0,1,23,24,0.3145790838565082,0.21515422449534122
46,53,0,1,8,9,1.471381434481806,1.006341323115994
46,54,0,2,14,16,1.664247986731749,1.1382510895623692
46,55,0,1,14,15,2.4125757385447772,1.6500647649531823
46,56,0,0,2,2,0.49809177287040524,0.34066647981060477
46,57,1,0,5,6,2.6140114766389226,1.7878353677662462
46,58,0,1,7,8,2.588239936121803,1.7702090979391638
46,59,1,2,7,10,0.06424540383899234,0.04394020692956647
46,60,0,1,13,14,0.8899304259402671,0.6086618611151047
46,61,0,0,1,1,0.09487179487179487,0.06488691874197478
46,62,0,1,0,1,0.020928844424038796,0.014314140776414986
46,63,1,2,8,11,0.13630302542214176,0.09322352704303284
46,64,0,0,11,11,0.39932904705127276,0.27311838531505944
46,65,0,0,10,10,0.5045152872300582,0.34505979876125764
46,66,0,0,9,9,0.7767247769611885,0.5312356275715691
46,67,0,0,8,8,0.8823219219065982,0.603458076537741
46,68,0,0,7,7,1.2758741907311941,0.8726254736809067
46,69,0,0,6,6,1.525657804452973,1.0434632771455103
46,70,0,1,12,13,1.744269327336884,1.1929811411281264
46,71,0,1,11,12,1.9495247429907532,1.3333641864249999
46,72,0,1,10,11,2.1965013215465077,1.502282137282516
46,73,0,0,5,5,0.8239314276108445,0.5635222951625464
46,74,0,0,3,3,0.2807624032960821,0.19202553586229804
46,75,1,0,4,5,0.1939006302432608,0.1326170170556417
46,76,1,0,5,6,2.3562813377578276,1.6115625924747639
46,77,1,1,8,10,0.19713081068179505,0.13482627699343802
46,78,1,1,4,6,7.5378641793286105,5.155470929511724
47,0,2,0,0,2,0.0008908026486376258,0.0006092584118957123
47,1,1,0,6,7,0.38995369328183244,0.26670617587982093
47,2,1,1,5,7,5.18670625527891,3.5474124609908713
47,3,1,1,4,6,5.491773733682507,3.756061287638908
47,4,1,1,5,7,5.763888119698652,3.942172070910294
47,5,1,0,9,10,0.7233795735585867,0.4947505385824094
47,6,1,0,8,9,1.1053776345486481,0.75601551387406
47,7,1,1,7,9,0.22773125462757982,0.15575524247218428
47,8,1,0,3,4,0.896296327917289,0.6130157764685623
47,9,1,0,2,3,0.49114457528019234,0.33591499127673907
47,10,1,0,1,2,0.34285664387651393,0.2344944693143514
47,11,1,0,1,2,0.05114878945304393,0.03498286660935445
47,12,1,0,2,3,0.0016134713922227198,0.001103522783153136
47,13,1,0,0,1,0.005001770929999436,0.0034209272032791767
47,14,0,1,8,9,0.1715592466565958,0.11733677972767477
47,15,1,1,1,3,0.26855215427841955,0.18367441910626953
47,16,1,2,5,8,12.450105979022386,8.515165293135727
47,17,1,2,5,8,12.68258713862931,8.674169200807546
47,18,1,0,7,8,0.1470420905512933,0.1005684375861683
47,19,0,0,11,11,0.04190013308308794,0.02865731099864054
47,20,0,0,8,8,0.007060762323061826,0.004829160360379318
47,21,0,0,9,9,0.04614655074226202,0.031561619470591155
47,22,0,1,12,13,0.24920852163680599,0.17044447314512123
47,23,0,1,13,14,0.1533524961076363,0.10488439654021425
47,24,0,1,10,11,0.5710980874188225,0.3905986520242301
47,25,0,1,11,12,0.32172632865574513,0.22004253395700782
47,26,0,2,8,10,0.6419799619964305,0.4390778279712159
47,27,0,1,16,17,0.2726004051772077,0.18644319277047353
47,28,0,1,15,16,0.38475308866351043,0.26314925772796965
47,29,0,0,9,9,0.9748554120228472,0.66674572764836
47,30,0,1,9,10,0.21129968867704826,0.14451698471521504
47,31,0,1,19,20,1.7410906170102958,1.1908070838232727
47,32,1,1,3,5,2.304518077628787,1.5761594628264672
47,33,0,0,7,7,1.12,0.7660163812566102
47,34,0,2,17,19,2.8544685059374695,1.9522943172581995
47,35,1,0,3,4,0.8465039540903225,0.5789606210997149
47,36,0,0,10,10,1.5454551592737054,1.0570035433046447
47,37,0,1,13,14,1.9677445795857433,1.3458255197246258
47,38,0,1,20,21,0.24289684435636968,0.1661276444040325
47,39,0,1,18,19,1.1708341571105576,0.8007840572155919
47,40,0,1,20,21,2.9699430533368725,2.0312723484422492
47,41,1,0,4,5,2.140440617278126,1.4639397999482635
47,42,1,1,6,8,2.588888888888889,1.7706529447697439
47,43,0,1,14,15,0.38370870187251527,0.2624349564866569
47,44,0,0,8,8,1.2678070680877143,0.8671080200250927
47,45,0,0,5,5,1.1195710801403644,0.765723024436318
47,46,0,0,4,4,0.2906666666666667,0.19879948942135836
47,48,0,2,9,11,0.649871376334388,0.44447510712671484
47,49,0,1,17,18,0.2379560605126373,0.1627484289035441
47,50,0,0,2,2,0.5946969696969697,0.40673894702816493
47,51,1,1,2,4,2.6285004768773477,1.7977450209186252
47,52,0,1,19,20,0.8647126690409941,0.5914143478263636
47,53,0,1,12,13,2.205387847945006,1.5083600165626228
47,54,0,2,18,20,2.4889231765909394,1.7022820758552666
47,55,0,1,18,19,3.4004838316416386,2.325737785031911
47,56,0,0,6,6,1.3365439955613156,0.9141201739911875
47,57,1,0,5,6,2.4600292681185723,1.6825202837049433
47,58,0,1,11,12,3.6568660305930676,2.501088645977791
47,59,1,2,7,10,0.4520749692857641,0.3091936000258698
47,60,0,1,17,18,1.3168312717396444,0.9006377906281627
47,61,0,0,3,3,0.4641025641025641,0.3174197916837144
47,62,0,1,4,5,0.4172737175666601,0.28539152064634443
47,63,1,2,8,11,0.4008724187882284,0.27417396391584203
47,64,0,0,7,7,1.3695337921047572,0.9366833209256509
47,65,0,0,6,6,1.3544678964341321,0.9263791040667206
47,66,0,0,5,5,1.7487311476022802,1.1960327727473374
47,67,0,0,4,4,1.733165972528332,1.1853870771368273
47,68,0,0,3,3,2.2485169520680173,1.537857873944005
47,69,0,0,2,2,2.498441996987057,1.7087924083138966
47,70,0,1,16,17,2.7171377242069776,1.8583678632793308
47,71,0,1,15,16,2.9224513100747553,1.998790693698307
47,72,0,1,14,15,3.10463922577523,2.123396879317559
47,73,0,0,1,1,0.033895384034165026,0.023182517338530516
47,74,0,0,1,1,0.6948994487991241,0.47527175098778407
47,75,1,0,4,5,0.2814148767174173,0.19247179062040276
47,76,1,0,5,6,3.3290949650067305,2.276911855316123
47,77,1,1,8,10,0.574977878835083,0.3932522089712964
47,78,1,1,4,6,11.500083579590301,7.865403935523506
48,0,4,0,0,4,0.00048492198450311675,0.0003316590926436175
48,1,3,0,6,9,0.49952099075465023,0.34164398366035165
48,2,3,1,5,9,3.2537612524290473,2.2253878750523888
48,3,3,1,4,8,3.3857831174841895,2.315683331584789
48,4,3,1,5,9,3.469787738711253,2.3731377208358486
48,5,3,0,9,12,0.24212213610645988,0.16559778796642044
48,6,3,0,8,11,0.3068568312082473,0.20987264232679653
48,7,3,1,7,11,0.15144361947808968,0.10357883335447263
48,8,3,0,3,6,1.8459806683980127,1.262545920960629
48,9,3,0,2,5,3.757515616881866,2.569927245856292
48,10,3,0,1,4,3.762440625099589,2.573295671724684
48,11,3,0,1,4,0.06288026366483265,0.043006528593746984
48,12,3,0,2,5,0.0009840535428078828,0.0006730367266289655
48,13,3,0,0,3,0.0011708520375396593,0.0008007962864134451
48,14,1,0,0,1,0.006903222324251905,0.004721411949851153
48,15,3,1,1,5,0.2918350933351417,0.1995986268930985
48,16,3,2,5,10,7.8185765257423245,5.347462229309835
48,17,3,2,5,10,7.643530186962583,5.2277404766453035
48,18,3,0,7,10,0.0965510584197215,0.06603543962247378
48,19,2,0,19,21,0.024411825907356657,0.016696302269124743
48,20,2,0,0,2,0.0002914858385315694,0.00019935975644598335
48,21,2,0,1,3,0.27279123701531716,0.1865737109080246
48,22,1,0,4,5,0.33542198400878886,0.22940958427171879
48,23,1,0,5,6,0.7673909622147559,0.5248518284685495
48,24,1,0,2,3,0.14327903821654192,0.09799472353978841
48,25,1,0,3,4,0.2010318667193661,0.1374943777335982
48,26,0,0,1,1,0.040551750201988125,0.027735093699418713
48,27,1,0,8,9,0.340625,0.23296815166565435
48,28,1,0,7,8,0.221875,0.15174989695652716
48,29,2,0,17,19,0.4370356859624961,0.29890758450088534
48,30,1,0,1,2,1.1849062766942144,0.8104085876799516
48,31,2,1,27,30,1.0715799245260107,0.7328998000112914
48,32,3,1,3,7,1.2142103393918773,0.8304509020226128
48,33,2,0,15,17,0.3412462154981894,0.23339302777985396
48,34,2,2,25,29,1.6714995035230422,1.1432107151436979
48,35,3,0,3,6,0.6386784215805906,0.43681976186236415
48,36,2,0,18,20,0.7761619379549499,0.530850677661936
48,37,2,1,21,24,1.0649070640909866,0.7283359425085523
48,38,1,0,12,13,0.7133964322498647,0.48792263699412314
48,39,1,0,10,11,0.3693556702030051,0.2526182981120678
48,40,2,1,28,31,1.5796898313043377,1.0804181143603695
48,41,3,0,4,7,1.609317877746905,1.1006820151814751
48,42,3,1,6,10,1.5485999695109365,1.059154414873986
48,43,1,0,6,7,0.08988413424493508,0.06147564218454333
48,44,2,0,16,18,0.48158472569290867,0.32937659718191
48,45,2,0,13,15,0.209048865750024,0.142977549685386
48,46,2,0,12,14,0.11121151019566275,0.07606235588764661
48,47,2,0,8,10,1.0686773744165492,0.7309146206083754
48,49,1,0,9,10,0.8913290495040516,0.6096184401874889
48,50,2,0,10,12,0.5183999629431224,0.35455612826540306
48,51,3,1,2,6,1.43878716526957,0.984048694409154
48,52,1,0,11,12,0.3440930106817051,0.23534007398043919
48,53,2,1,20,23,1.2611360453876137,0.8625454194286536
48,54,2,2,26,30,1.4137899206929847,0.9669519990234913
48,55,2,1,26,29,2.102292383200493,1.4378485747523007
48,56,2,0,14,16,0.3156717735861939,0.21590156220299309
48,57,3,0,5,8,2.53129216014272,1.7312600539426382
48,58,2,1,19,22,2.27900586729734,1.5587105601157956
48,59,3,2,7,12,0.2427112497793778,0.16600070825559665
48,60,2,1,25,28,0.7601624707455813,0.5199079508996555
48,61,2,0,11,13,0.2947045233475816,0.20156115403095423
48,62,2,1,12,15,0.13633332996558153,0.09324425362937334
48,63,3,2,8,13,0.3331823637714708,0.22787781124530856
48,64,2,0,1,3,0.19715015595313878,0.13483950806017833
48,65,2,0,2,4,0.2857242310019236,0.19541914416912617
48,66,2,0,3,5,0.5090117804784249,0.34813514473131
48,67,2,0,4,6,0.6404850504527921,0.4380553933900047
48,68,2,0,5,7,0.994486654989161,0.6801723827346324
48,69,2,0,6,8,1.241555099097252,0.8491531644117583
48,70,2,1,24,27,1.4585597567787165,0.9975720238697805
48,71,2,1,23,26,1.6626947316711629,1.1371887513296206
48,72,2,1,22,25,1.9273479548044479,1.3181965230014572
48,73,2,0,7,9,1.0783784523557536,0.737549606873802
48,74,2,0,9,11,0.606358638751247,0.41471486624992365
48,75,3,0,4,7,0.1687747678884288,0.11543235441546301
48,76,3,0,5,8,2.0831681747884714,1.4247687025003595
48,77,3,1,8,12,0.4808777069277196,0.32889303650691837
48,78,3,1,4,8,5.935292822117144,4.059403151157596
49,0,3,0,0,3,0.0007739527055690873,0.000529339688199817
49,1,2,0,6,8,0.37027577790722155,0.25324759951738046
49,2,2,1,5,8,4.976337721075363,3.4035323330436755
49,3,2,1,4,7,5.263610249669177,3.6000104248185587
49,4,2,1,5,8,5.516480948192645,3.7729596189335393
49,5,2,0,9,11,0.675697923317343,0.4621389982519265
49,6,2,0,8,10,1.0258468707165218,0.7016209889550783
49,7,2,1,7,10,0.20968120452211234,0.1434100334871033
49,8,2,0,3,5,0.9254549919627428,0.6329586463921121
49,9,2,0,2,4,1.1542201485135182,0.7894210190516006
49,10,2,0,1,3,1.1631503610384097,0.7955287771606807
49,11,2,0,1,3,0.043444368156764085,0.0297134800727003
49,12,2,0,2,4,0.001413683269444265,0.000966879055627419
49,13,2,0,0,2,0.004523259983146135,0.0030936528962253913
49,14,0,0,9,9,0.14976745248638984,0.10243243034254076
49,15,2,1,1,4,0.2396022497018835,0.16387432880141029
49,16,2,2,5,9,11.949944792991953,8.1730834522714
49,17,2,2,5,9,12.143038681884862,8.305148704068287
49,18,2,0,7,9,0.13455610019030606,0.09202872941408942
49,19,1,0,19,20,0.039745462558666664,0.02718363875049994
49,20,1,0,0,1,0.006165583758415237,0.004216909070496224
49,21,1,0,1,2,0.05079093804759962,0.03473811657486692
49,22,0,0,5,5,0.17773759876541723,0.12156242162457523
49,23,0,0,4,4,0.052595621083969035,0.03597241726132664
49,24,0,0,7,7,0.48404194149668156,0.3310571932158141
49,25,0,0,6,6,0.25732291166035803,0.17599425500400162
49,26,0,1,9,10,0.5636400655176939,0.3854977886777701
49,27,0,0,1,1,0.17960218385210253,0.12283769191086784
49,28,0,0,2,2,0.29817878911448037,0.20393735446870728
49,29,1,0,17,18,0.9149089517445869,0.6257457539238099
49,30,0,0,8,8,0.165919051525356,0.1134792066348056
49,31,1,1,27,29,1.6521405543677548,1.129970293557212
49,32,2,1,3,6,2.1208912536088045,1.4505691456501892
49,33,1,0,15,16,1.0343301095444355,0.7074230424446265
49,34,1,2,25,28,2.7110275061107165,1.8541888211768427
49,35,2,0,3,5,0.7914965555680874,0.5413386850654803
49,36,1,0,18,19,1.4590372771274476,0.9978986206639869
49,37,1,1,21,23,1.8658557805909382,1.2761393687455342
49,38,0,0,3,3,0.05506829855384138,0.03766358819658232
49,39,0,0,1,1,1.0569444444444445,0.7228899629666176
49,40,1,1,28,30,2.7817887445978093,1.9025854888903417
49,41,2,0,4,6,1.9935649647958438,1.3634851965472088
49,42,2,1,6,9,2.4701489433775317,1.6894415667597287
49,43,0,0,3,3,0.31791545218623096,0.2174361109189782
49,44,1,0,16,17,1.1809331599296218,0.8076912014957345
49,45,1,0,13,14,1.0165239112848359,0.695244614270737
49,46,1,0,12,13,0.2561987076036446,0.17522536328675378
49,47,1,0,8,9,0.24676924793903127,0.16877614849256423
49,48,0,1,10,11,0.5620994005881406,0.38444406137949755
49,50,1,0,10,11,0.5117878431272269,0.35003381389593224
49,51,2,1,2,5,2.431138422175459,1.6627605861506698
49,52,0,0,2,2,0.6747592163134936,0.46149697598215056
49,53,1,1,20,22,2.0981767241215,1.4350336977217863
49,54,1,2,26,29,2.3587089580544363,1.613222946862865
49,55,1,1,26,28,3.236567920008237,2.21362861229995
49,56,1,0,14,15,1.2243401797456641,0.8373791374248585
49,57,2,0,5,7,2.2370346443450533,1.530004627684702
49,58,1,1,19,21,3.4993142418763554,2.3933321718230753
49,59,2,2,7,11,0.41486800142050845,0.2837461474529466
49,60,1,1,25,27,1.2493339248058928,0.8544734393401142
49,61,1,0,11,12,0.4030721112781233,0.2756784286310087
49,62,1,1,12,14,0.3696379734347632,0.2528113774870753
49,63,2,2,8,12,0.36999111345582497,0.2530529052022634
49,64,1,0,1,2,1.23007072137818,0.8412985023926979
49,65,1,0,2,3,1.2308097245817486,0.8418039386067466
49,66,1,0,3,4,1.6058092184856425,1.098282291547212
49,67,1,0,4,5,1.6068747645006636,1.0990110644958626
49,68,1,0,5,6,2.1029439474635243,1.438294207697768
49,69,1,0,6,7,2.351966888834422,1.6086117544824217
49,70,1,1,24,26,2.570017594039673,1.7577460510286522
49,71,1,1,23,25,2.774818434950074,1.8978181930219524
49,72,1,1,22,24,2.9660879878029394,2.028635702594204
49,73,1,0,7,8,0.23656167080001675,0.16179474554486284
49,74,1,0,9,10,0.5844805440539069,0.39975149220631123
49,75,2,0,4,6,0.26862729063053725,0.1837258081031892
49,76,2,0,5,7,3.191717647814002,2.182953573724413
49,77,2,1,8,11,0.5228664023355852,0.35761091910514986
49,78,2,1,4,7,10.552235459968395,7.2171296617970295
50,0,2,0,0,2,0.000683734480693216,0.00046763554700087953
50,1,1,0,6,7,0.1054660163559733,0.07213276445942245
50,2,1,1,5,7,4.09714130098997,2.8022119222154798
50,3,1,1,4,6,4.3032470335944675,2.9431765360064968
50,4,1,1,5,7,4.467400837299442,3.0554484134025617
50,5,1,0,9,10,0.4332255383179977,0.29630165993776747
50,6,1,0,8,9,0.5982886216126986,0.4091954329238971
50,7,1,1,7,9,0.04761723727373422,0.032567485519520774
50,8,1,0,3,4,0.6018223015514033,0.411612269280295
50,9,1,0,2,3,1.8740481122854058,1.2817424582800432
50,10,1,0,1,2,2.097830220101978,1.4347967086547104
50,11,1,0,1,2,0.057564149871625066,0.03937060872747804
50,12,1,0,2,3,0.00129765216913794,0.0008875203738686032
50,13,1,0,0,1,0.002903022186442064,0.001985502276755359
50,14,0,1,10,11,0.0800202373071013,0.05472929697257226
50,15,1,1,1,3,0.28510912872969196,0.19499844915423542
50,16,1,2,5,8,9.835684747105535,6.727049676034482
50,17,1,2,5,8,9.830905055735002,6.7237806386352155
50,18,1,0,7,8,0.029275501342492613,0.02002277999807967
50,19,0,0,9,9,0.03227042408238734,0.022071137033220105
50,20,0,0,10,10,0.003448462685578537,0.002358552595808324
50,21,0,0,11,11,0.16480713546600523,0.11271871920976542
50,22,0,1,14,15,0.1010151513888952,0.06908862564197335
50,23,0,1,15,16,0.4005964332038968,0.27398520545281646
50,24,0,1,12,13,0.19505000746157522,0.1334031257855274
50,25,0,1,13,14,0.06766856049137594,0.04628145163611413
50,26,0,2,10,12,0.2980512840120548,0.20385014822125033
50,27,0,1,18,19,0.1306575584091653,0.0893623482825116
50,28,0,1,17,18,0.11451228858123093,0.07831990081107783
50,29,0,0,7,7,0.6711805807163649,0.45904939250898213
50,30,0,1,11,12,0.5794661363549742,0.39632192217088114
50,31,0,1,17,18,1.3775577903838678,0.942171279965806
50,32,1,1,3,5,1.7384516525787148,1.1890021820517152
50,33,0,0,5,5,0.6714285714285714,0.45921900406965155
50,34,0,2,15,17,2.2010108552031773,1.5053664021511202
50,35,1,0,3,4,0.7458276267855578,0.5101037318852489
50,36,0,0,8,8,1.1129485107598405,0.7611935631582023
50,37,0,1,11,12,1.4612938830690798,0.9994420109473184
50,38,0,1,22,23,0.40816737711643003,0.27916330104083026
50,39,0,1,20,21,0.7461759506863752,0.5103419656477571
50,40,0,1,18,19,2.219391444223554,1.5179376809785794
50,41,1,0,4,5,1.8846164718505747,1.2889706159139085
50,42,1,1,6,8,2.0074074074074075,1.3729526410088715
50,43,0,1,16,17,0.14512159026911448,0.0992549244822782
50,44,0,0,6,6,0.8205140570582641,0.5611850078195993
50,45,0,0,3,3,0.5507365559351115,0.37667252107423466
50,46,0,0,2,2,0.08133333333333333,0.05562738006744432
50,47,0,0,2,2,0.5814814814814815,0.3977003037608724
50,48,0,2,11,13,0.3082378158040187,0.21081715734699644
50,49,0,1,19,20,0.4825428235199568,0.33003188167330755
50,51,1,1,2,4,2.0090128950556787,1.3740507033646583
50,52,0,1,21,22,0.35674080226405275,0.24399044499722292
50,53,0,1,10,11,1.676768521898831,1.1468144244195875
50,54,0,2,16,18,1.8949107357631811,1.2960113076907258
50,55,0,1,16,17,2.6887862096105253,1.8389770377308319
50,56,0,0,4,4,0.7327024025147506,0.501126824028905
50,57,1,0,5,6,2.5418890613085376,1.7385077324101144
50,58,0,1,9,10,2.887259063214818,1.9747211958519335
50,59,1,2,7,10,0.11875055685019527,0.08121863556303031
50,60,0,1,15,16,1.009337413657973,0.690329458104631
50,61,0,0,1,1,0.06153846153846154,0.04208881215695662
50,62,0,1,2,3,0.13182131657714632,0.09015829276509613
50,63,1,2,8,11,0.06367656723960158,0.04355115500689539
50,64,0,0,9,9,0.669929254232132,0.4581935562721763
50,65,0,0,8,8,0.7419741675309208,0.5074681846410016
50,66,0,0,7,7,1.0484824317830286,0.7171024269692556
50,67,0,0,6,6,1.1202921377377213,0.7662161868750726
50,68,0,0,5,5,1.5479633102104366,1.058718976076252
50,69,0,0,4,4,1.7978119784220075,1.2296012731166188
50,70,0,1,14,15,2.0164603355279898,1.3791443296148582
50,71,0,1,13,14,2.221740269028529,1.5195441437261799
50,72,0,1,12,13,2.450598708025812,1.6760703162804078
50,73,0,0,3,3,0.5998170496739691,0.4102407908993485
50,74,0,0,1,1,0.031959422016241856,0.021858429285655737
50,75,1,0,4,5,0.2183884963689138,0.1493653265148105
50,76,1,0,5,6,2.6284607668500395,1.7977178615155731
50,77,1,1,8,10,0.07092603547158158,0.04850937949001688
50,78,1,1,4,6,8.616531637197479,5.893218199740276
51,0,2,0,0,2,0.0004980101548902451,0.0003406106577482764
51,1,1,0,8,9,1.5079167359626842,1.031329394034299
51,2,1,1,7,9,1.7050272888008435,1.1661418158133854
51,3,1,1,6,8,1.7728446283351262,1.2125250238638337
51,4,1,1,7,9,1.8289407445233605,1.2508915809397814
51,5,1,0,11,12,0.5512561728958963,0.3770279095598954
51,6,1,0,10,11,1.0854175808618485,0.7423639709322297
51,7,1,1,9,11,0.5651559834090972,0.38653459040764065
51,8,1,0,5,6,4.985120421798726,3.4095392014595416
51,9,1,0,4,5,8.545530404367847,5.844657389528747
51,10,1,0,3,4,8.01118045893856,5.47919237924088
51,11,1,0,1,2,0.09623758870405079,0.0658210441428027
51,12,1,0,0,1,0.0009015172299519965,0.0006165865769002783
51,13,1,0,2,3,0.003707784154228379,0.0025359137502702005
51,14,1,2,21,24,0.20731575467674473,0.14179220015621716
51,15,1,1,1,3,0.3794297465847444,0.259508394124963
51,16,1,2,7,10,4.139956051833293,2.8314947798095917
51,17,1,2,7,10,4.0733968605417115,2.785972073691249
51,18,1,0,9,10,0.3646683514317464,0.24941243832371449
51,19,1,1,2,4,0.009854522619847558,0.006739933710952711
51,20,1,1,21,23,0.00793911168566374,0.005429901432003754
51,21,1,1,22,24,0.5717277397663746,0.39102929846416007
51,22,1,2,25,28,1.0252649648446714,0.7012229983924116
51,23,1,2,26,29,1.7897249071694,1.2240701757452914
51,24,1,2,23,26,0.9957461727175424,0.6810338213171532
51,25,1,2,24,27,0.8232235684723201,0.5630381597199285
51,26,1,3,21,25,0.7767556776207363,0.5312567618674666
51,27,1,2,29,32,1.0439578967936292,0.7140079020411764
51,28,1,2,28,31,0.9295029286906223,0.6357272051812604
51,29,1,1,4,6,0.3954956854457076,0.27049658372118174
51,30,1,2,22,25,2.8141395531170694,1.9247116043123498
51,31,1,2,10,13,0.39699987703291184,0.2715253653250629
51,32,0,0,1,1,0.11687393902428847,0.07993513556659926
51,33,1,1,6,8,0.7923679314406346,0.5419346566660185
51,34,1,3,8,12,0.7026981729179479,0.4806056352984269
51,35,1,0,1,2,0.40411115410143106,0.2763890749019738
51,36,1,1,3,5,0.5041134139708647,0.3447849402793548
51,37,1,2,4,7,0.5743770094732609,0.39284124845866164
51,38,1,2,33,36,1.6592015983146575,1.1347996465323016
51,39,1,2,31,34,0.5995191617526848,0.41003705248195366
51,40,1,2,11,14,0.4859936996262961,0.33239208491182803
51,41,1,0,2,3,1.0328043789201313,0.7063795293628392
51,42,1,1,8,10,0.74140016944177,0.5070756025525199
51,43,1,2,27,30,0.6482157125034453,0.44334272711211115
51,44,1,1,5,7,0.6817783467590206,0.4662976625030888
51,45,1,1,8,10,1.2529960419232793,0.8569781194311842
51,46,1,1,9,11,0.5680144755588932,0.3884896366687452
51,47,1,1,13,15,2.33644486833542,1.5979955741498888
51,48,1,3,22,26,0.7777227920376054,0.5319182131941373
51,49,1,2,30,33,2.0838329332932504,1.4252233595577168
51,50,1,1,11,13,1.8263753591415262,1.2491370030587803
51,52,1,2,32,35,1.6628277120615953,1.1372797023630643
51,53,1,2,3,6,0.6204474594502059,0.42435081932848595
51,54,1,3,9,13,0.598331995248548,0.4092250980270893
51,55,1,2,9,12,0.8656077977375967,0.5920265650093371
51,56,1,1,7,9,1.2055591155414525,0.8245339563196278
51,57,1,0,3,4,2.99897649207192,2.051129571366585
51,58,1,2,2,5,1.1116135085831031,0.7602804975007077
51,59,1,2,9,12,0.9856474250026128,0.6741268515137478
51,60,1,2,8,11,0.3191398594721178,0.2182735359531918
51,61,1,1,10,12,1.1792899779405426,0.8065673583519664
51,62,1,2,9,12,0.75598384258391,0.5170500065933872
51,63,1,2,10,13,1.150581534912118,0.786932414030408
51,64,1,1,20,22,1.522426158944589,1.0412530151831565
51,65,1,1,19,21,1.1974870436570755,0.8190131176641692
51,66,1,1,18,20,1.203636337800363,0.8232188855632081
51,67,1,1,17,19,0.9004732371265955,0.6158725451090538
51,68,1,1,16,18,0.8621967819566055,0.5896936239691908
51,69,1,1,15,17,0.7603977376266682,0.5200688600825838
51,70,1,2,7,10,0.7322653425417285,0.5008278998334349
51,71,1,2,6,9,0.7641235016444045,0.522617071038193
51,72,1,2,5,8,0.8971042341581297,0.6135683384462439
51,73,1,1,14,16,2.3334215907729723,1.5959278240267458
51,74,1,1,12,14,2.1475024055010166,1.4687696619658523
51,75,1,0,6,7,0.08162329732975818,0.055825698970333654
51,76,1,0,7,8,1.0716610610855182,0.7329552928092392
51,77,1,1,10,12,1.675673723222254,1.1460656443120554
51,78,0,0,2,2,0.9118174136146212,0.6236313174498518
52,0,3,0,0,3,0.0005161839430268091,0.0003530404965180042
52,1,2,0,6,8,0.3633857145303162,0.248535187540054
52,2,2,1,5,8,3.8457506336158604,2.630274985337266
52,3,2,1,4,7,4.032328182245297,2.7578834305380244
52,4,2,1,5,8,4.176026188511768,2.8561647044255527
52,5,2,0,9,11,0.3965338114376901,0.27120660293159865
52,6,2,0,8,10,0.5568205482513797,0.3808336262328961
52,7,2,1,7,10,0.12694474333513148,0.08682299366886305
52,8,2,0,3,5,1.3374608977060085,0.9147472829758696
52,9,2,0,2,4,2.8467987489957824,1.9470486391710669
52,10,2,0,1,3,2.918264961515994,1.9959274690789668
52,11,2,0,1,3,0.051764369123146976,0.035403888137271834
52,12,2,0,2,4,0.0010182558095874303,0.0006964291343336458
52,13,2,0,0,2,0.0023252281335346724,0.0015903239646841891
52,14,0,0,11,11,0.05448461109161915,0.037264379127299886
52,15,2,1,1,4,0.2569893879065616,0.17576614370137109
52,16,2,2,5,9,9.240618365552049,6.3200580722799575
52,17,2,2,5,9,9.198369420718,6.291162193857022
52,18,2,0,7,9,0.07981620563548086,0.05458975089868261
52,19,1,0,19,20,0.02954189829346001,0.020204980380542022
52,20,1,0,0,1,0.002321410301404085,0.0015877127843690838
52,21,1,0,1,2,0.20134324513053292,0.13770734287977987
52,22,0,0,7,7,0.19025595076997567,0.1301242633226362
52,23,0,0,6,6,0.5301731442667996,0.3626083155452613
52,24,0,0,9,9,0.12851964516056022,0.08790013705917497
52,25,0,0,8,8,0.09399800040998427,0.06428929296376207
52,26,0,1,11,12,0.21269580666491641,0.14547185011599542
52,27,0,0,3,3,0.178222439235979,0.12189402496631317
52,28,0,0,4,4,0.07442633615790105,0.05090338633380658
52,29,1,0,17,18,0.6030668924066068,0.41246349872944504
52,30,0,0,10,10,0.8268829974086933,0.5655410012478806
52,31,1,1,27,29,1.2610727996586366,0.8625021629425457
52,32,2,1,3,6,1.479092212818308,1.0116150575070644
52,33,1,0,15,16,0.5857421596154919,0.4006143655875812
52,34,1,2,25,28,2.020757086190443,1.3820830630020136
52,35,2,0,3,5,0.6698906348083082,0.4581671427799587
52,36,1,0,18,19,1.0117630745232806,0.6919884723530227
52,37,1,1,21,23,1.3399644333422691,0.9164595591441155
52,38,0,0,1,1,0.47414663872185153,0.32428936819526616
52,39,0,0,1,1,0.5902794117624444,0.4037175883290609
52,40,1,1,28,30,1.9710159728136907,1.3480629668693935
52,41,2,0,4,6,1.6821494233650693,1.1504946553741109
52,42,2,1,6,9,1.8627015500267021,1.2739820542076188
52,43,0,0,5,5,0.06012539049991535,0.04112235183248726
52,44,1,0,16,17,0.7266646918200104,0.49699737287045914
52,45,1,0,13,14,0.47975447494284335,0.32812480963159096
52,46,1,0,12,13,0.10485969461883607,0.0717180748317804
52,47,1,0,8,9,0.8006598787416612,0.5476058776170033
52,48,0,1,12,13,0.19374606457303215,0.13251130291691396
52,49,0,0,2,2,0.6024635859941907,0.4120508714126344
52,50,1,0,10,11,0.33782272941671665,0.23105155776252168
52,51,2,1,2,5,1.7321122000641618,1.1846663566281919
52,53,1,1,20,22,1.5474128053876368,1.0583424620474793
52,54,1,2,26,29,1.7317712055189227,1.1844331357285738
52,55,1,1,26,28,2.4782702328655444,1.6949960674603937
52,56,1,0,14,15,0.634956202188958,0.43427397522966626
52,57,2,0,5,7,2.30293378107144,1.5750758939731673
52,58,1,1,19,21,2.6939385447217252,1.8425009422816385
52,59,2,2,7,11,0.22594371784797337,0.15453266885140102
52,60,1,1,25,27,0.9246132435427061,0.6323829382861792
52,61,1,0,11,12,0.20464687117164013,0.139966835437846
52,62,1,1,12,14,0.14951712912180481,0.10226122338014487
52,63,2,2,8,12,0.2571456128600135,0.17587299269557216
52,64,1,0,1,2,0.5470571853969087,0.37415604062336305
52,65,1,0,2,3,0.6173389104230071,0.4222247483670809
52,66,1,0,3,4,0.8929268945968577,0.6107112754694533
52,67,1,0,4,5,0.9759236191426002,0.6674763206414901
52,68,1,0,5,6,1.3759725949129693,0.9410870963066968
52,69,1,0,6,7,1.6213548819984174,1.1089146423581842
52,70,1,1,24,26,1.8370861175731807,1.2564625534287175
52,71,1,1,23,25,2.040194445468097,1.3953771126583112
52,72,1,1,22,24,2.2781609603167,1.558132691733824
52,73,1,0,7,8,0.8068491946066317,0.5518390181003415
52,74,1,0,9,10,0.3751660452964359,0.2565922646324369
52,75,2,0,4,6,0.20284754383708925,0.13873619774721313
52,76,2,0,5,7,2.4631258997507537,1.6846382038450933
52,77,2,1,8,11,0.3578621538812892,0.2447573858078941
52,78,2,1,4,7,7.272084845013815,4.973692961757607
53,0,3,0,0,3,0.000774765088589618,0.0005298953120405146
53,1,2,0,6,8,1.533837558331046,1.0490577641680559
53,2,2,1,5,8,0.6560386931998055,0.44869320154395587
53,3,2,1,4,7,0.5570242867368462,0.38097297178411016
53,4,2,1,5,8,0.3997813759486884,0.2734277525875024
53,5,2,0,9,11,0.4958583601210777,0.3391389523533795
53,6,2,0,8,10,1.0275614979057996,0.7027936965575201
53,7,2,1,7,10,0.569357732653087,0.38940834822088066
53,8,2,0,3,5,5.091040988551107,3.481982852570531
53,9,2,0,2,4,8.763825607272851,5.99395890861354
53,10,2,0,1,3,8.228013012904595,5.627493529533462
53,11,2,0,1,3,0.11256747662259961,0.07698975990145698
53,12,2,0,2,4,0.001405718420239386,0.0009614315511942263
53,13,2,0,0,2,0.003877445647985072,0.0026519525748113543
53,14,1,1,19,21,0.22122546528582487,0.15130565210719413
53,15,2,1,1,4,0.4525420868672567,0.30951308191818805
53,16,2,2,5,9,1.5900078616157847,1.087475061004004
53,17,2,2,5,9,0.9078172896596313,0.6208954598814773
53,18,2,0,7,9,0.368285197812924,0.25188615580270624
53,19,1,0,0,1,0.0027285534022948713,0.0018661755386529726
53,20,1,0,19,20,0.008557789394646602,0.005853041842538738
53,21,1,0,20,21,0.6055049466632568,0.41413098935354
53,22,1,1,23,25,1.0848785805505112,0.7419953253358129
53,23,1,1,24,26,1.8948876414061384,1.2959955124623246
53,24,1,1,21,23,1.0550031042933417,0.7215621965761391
53,25,1,1,22,24,0.872584018688308,0.5967979038731858
53,26,1,2,19,22,0.8211592227673038,0.5616262645175899
53,27,1,1,27,29,1.1186985944117784,0.7651262937572919
53,28,1,1,26,28,1.0005608236411994,0.6843267690649688
53,29,1,0,2,3,0.29206963249516443,0.19975903835615527
53,30,1,1,20,22,2.9542035328951677,2.0205074105034373
53,31,0,0,7,7,0.2725678413521705,0.18642092096385313
53,32,2,1,3,6,0.7442128077895398,0.5089992874176469
53,33,1,0,4,5,0.7514299293849761,0.5139353886387407
53,34,0,1,5,6,0.1709095358499474,0.1168924144410925
53,35,2,0,3,5,0.5470163411642922,0.37412810548830583
53,36,1,0,1,2,0.25895316804407714,0.1771092577679097
53,37,0,0,1,1,0.14517025061951347,0.09928820539792402
53,38,1,1,31,33,1.7894161773181887,1.2238590220636747
53,39,1,1,29,31,0.7014603923948703,0.4797590637296076
53,40,0,0,8,8,0.43084637954595745,0.29467445047973784
53,41,2,0,4,6,1.427136368453708,0.9760802111809016
53,42,2,1,6,9,0.16297348450882815,0.11146460611092211
53,43,1,1,25,27,0.7013445166987633,0.47967981133549376
53,44,1,0,3,4,0.5982905982905983,0.4091967848593004
53,45,1,0,6,7,1.2536244973604629,0.8574079472524095
53,46,1,0,7,8,0.5826670480547951,0.39851116395393354
53,47,1,0,11,12,2.425926632739507,1.6591960182188847
53,48,1,2,20,23,0.8435977600903631,0.5769729494826804
53,49,1,1,28,30,2.225566025228877,1.5221607436548947
53,50,1,0,9,10,1.886364587136185,1.2901662274720358
53,51,2,1,2,5,0.7678037310696298,0.5251341389190013
53,52,1,1,30,32,1.8383264128005126,1.2573108449124055
53,54,0,1,6,7,0.10621268858189357,0.07264344584914054
53,55,0,0,6,6,0.47286929684726464,0.32341573890919595
53,56,1,0,5,6,1.1826938711684474,0.8088954279703803
53,57,2,0,5,7,3.6040072141992168,2.464936218074644
53,58,0,0,1,1,0.4460851647843455,0.305096913982467
53,59,2,2,7,11,0.9895200021042937,0.6767754742794326
53,60,0,0,5,5,0.06408645880550673,0.04383149755512955
53,61,1,0,8,9,1.2153852915718124,0.8312545025735267
53,62,1,1,7,9,0.7736363636363637,0.5291233282868307
53,63,2,2,8,12,1.1645571306971574,0.7964909276993017
53,64,1,0,18,19,1.5569704452797075,1.0648793448362988
53,65,1,0,17,18,1.2062314046898943,0.8249937639094916
53,66,1,0,16,17,1.1778821374481352,0.805604475423948
53,67,1,0,15,16,0.8278531762019495,0.566204548433936
53,68,1,0,14,15,0.6790191779361626,0.46441054775580143
53,69,1,0,13,14,0.43057798497828387,0.294490883840918
53,70,0,0,4,4,0.21616088024422736,0.14784176361957727
53,71,0,0,3,3,0.060309178955831676,0.04124805269669955
53,72,0,0,2,2,0.3791952828029378,0.2593480342163244
53,73,1,0,12,13,2.4303034845534977,1.6621895362437507
53,74,1,0,10,11,2.230162067558439,1.525304175541853
53,75,2,0,4,6,0.018483925223960397,0.012641954920960645
53,76,2,0,5,7,0.4115020589441882,0.28144403399292084
53,77,2,1,8,11,1.7043359538529015,1.1656689819785115
53,78,2,1,4,7,3.965440865913075,2.7121363055301906
54,0,4,0,0,4,0.000739858673021249,0.0005060213065616561
54,1,3,0,6,9,1.5441988042322259,1.0561442678203166
54,2,3,1,5,9,0.7200906712669447,0.49250111623263254
54,3,3,1,4,8,0.6485131684555362,0.44354617008711456
54,4,3,1,5,9,0.5447183862758543,0.3725564348740807
54,5,3,0,9,12,0.5063006353946515,0.3462808754936906
54,6,3,0,8,11,1.043506695544635,0.7136993060162006
54,7,3,1,7,11,0.5740469004301654,0.3926154726241866
54,8,3,0,3,6,5.1218620710031,3.503062722254717
54,9,3,0,2,5,8.808589119941434,6.024574608601685
54,10,3,0,1,4,8.266676715040282,5.653937305601285
54,11,3,0,1,4,0.1109493589435795,0.0758830593220549
54,12,3,0,2,5,0.0013411093170549262,0.0009172425945713737
54,13,3,0,0,3,0.003868696965639293,0.002645968973033429
54,14,2,1,19,22,0.22094882104069793,0.15111644315759806
54,15,3,1,1,5,0.44443646837854006,0.3039692992908903
54,16,3,2,5,10,1.7579185924774157,1.202316463172557
54,17,3,2,5,10,1.2418660978377167,0.8493658698847458
54,18,3,0,7,10,0.37118118348416157,0.253866845502753
54,19,2,0,0,2,0.001583597415528095,0.0010830906800090641
54,20,2,0,19,21,0.008532777562629669,0.00583593517017248
54,21,2,0,20,22,0.6056074664170696,0.4142011070417748
54,22,2,1,23,26,1.0859055662845958,0.7426977252426217
54,23,2,1,24,27,1.8958329927647803,1.2966420790933628
54,24,2,1,21,24,1.0556277500399815,0.7219894187854323
54,25,2,1,22,25,0.8732452511714861,0.5972501493320549
54,26,2,2,19,23,0.8212020698379742,0.56165556948011
54,27,2,1,27,30,1.1177393984499349,0.764470258204071
54,28,2,1,26,29,0.999116906079508,0.6833392114708262
54,29,2,0,2,4,0.29990171323867565,0.2051157367033464
54,30,2,1,20,23,2.959426841415068,2.0240798568343306
54,31,1,0,2,3,0.23173551552555471,0.15849392947457186
54,32,3,1,3,7,0.6507011732372746,0.4450426410737926
54,33,2,0,4,6,0.7597878328983744,0.5196517198925132
54,34,0,0,1,1,0.11668526637450372,0.07980609419121515
54,35,3,0,3,6,0.5225158879743234,0.357371187192121
54,36,2,0,1,3,0.2741600508887606,0.18750990184547905
54,37,1,0,4,5,0.17593218350997913,0.12032762014186435
54,38,2,1,31,34,1.7856195594225004,1.22126235108022
54,39,2,1,29,32,0.6858636530807591,0.46909177997175205
54,40,1,0,3,4,0.32633735242257317,0.22319621229607378
54,41,3,0,4,7,1.3622291837991511,0.9316873837642603
54,42,3,1,6,10,0.18748571047515356,0.12822957631741222
54,43,2,1,25,28,0.6996756066545384,0.47853837166342234
54,44,2,0,3,5,0.607821587647268,0.41571544019572126
54,45,2,0,6,8,1.263285312808827,0.8640153962611093
54,46,2,0,7,9,0.5858152913295757,0.40066438352595396
54,47,2,0,11,13,2.4336137726666967,1.6644535852807052
54,48,2,2,20,24,0.8406318447363693,0.5749444318518057
54,49,2,1,28,31,2.223925589022754,1.5210387784707013
54,50,2,0,9,11,1.8949107357631811,1.2960113076907258
54,51,3,1,2,6,0.6581651947734027,0.4501476078297982
54,52,2,1,30,33,1.8287503930279825,1.250761391329374
54,53,1,0,5,6,0.09441127873946095,0.0645719518659027
54,55,1,0,1,2,0.42060193976673144,0.28766783558002
54,56,2,0,5,7,1.1935059115675741,0.8162902494530045
54,57,3,0,5,8,3.5329228692401426,2.4163185638875486
54,58,1,0,6,7,0.4604321766686199,0.3149094551658933
54,59,3,2,7,12,0.9981473537570742,0.6826760927552282
54,60,1,0,0,1,0.028448270840288056,0.019457001323290538
54,61,2,0,8,10,1.2212680813382975,0.8352779966169342
54,62,2,1,7,10,0.7780309964294216,0.5321290074913753
54,63,3,2,8,13,1.1733439866940603,0.8025006380862396
54,64,2,0,18,20,1.5638403052482304,1.069577938829895
54,65,2,0,17,19,1.2122614360387123,0.8291179628315323
54,66,2,0,16,18,1.1848053644351833,0.8103395694268379
54,67,2,0,15,17,0.8339569301690305,0.5703791694392433
54,68,2,0,14,16,0.6860962303559709,0.46925084961703795
54,69,2,0,13,15,0.4378472109832566,0.2994626215184765
54,70,1,0,1,2,0.22384954247399372,0.15310037184988978
54,71,1,0,2,3,0.06534500521564485,0.04469227181114517
54,72,1,0,3,4,0.3736666109128713,0.2555667366856245
54,73,2,0,12,14,2.436827551197121,1.6666516272450231
54,74,2,0,10,12,2.2384787311153107,1.5309923010078923
54,75,3,0,4,7,0.021544745342001615,0.014735382019620795
54,76,3,0,5,8,0.44623321618525985,0.30519817273101024
54,77,3,1,8,12,1.7159462611575447,1.1736097726809935
54,78,3,1,4,8,3.507900129963695,2.399204431575342
55,0,3,0,0,3,0.0008497992224712447,0.0005812143974929499
55,1,2,0,6,8,1.812667999994831,1.2397619480140156
55,2,2,1,5,8,0.5069444444444444,0.3467212043138179
55,3,2,1,4,7,0.5812265181330628,0.3975259233130968
55,4,2,1,5,8,0.7323498588962939,0.5008857042192216
55,5,2,0,9,11,0.6778950147580614,0.46364168399720235
55,6,2,0,8,10,1.3433841266074449,0.9187984350905419
55,7,2,1,7,10,0.6855298300162123,0.4688634639575697
55,8,2,0,3,5,5.955782314289754,4.073416799950318
55,9,2,0,2,4,10.081020644639823,6.894845494268016
55,10,2,0,1,3,9.396971788771294,6.426994932504503
55,11,2,0,1,3,0.12196261127665534,0.08341549833816979
55,12,2,0,2,4,0.0014970734021668253,0.0010239131696458514
55,13,2,0,0,2,0.005083159962262709,0.0034765926782508645
55,14,1,1,19,21,0.27446302062064504,0.1877171159326651
55,15,2,1,1,4,0.47902622397029887,0.3276267273328097
55,16,2,2,5,9,1.275,0.8720275768769447
55,17,2,2,5,9,1.6566919143804482,1.1330831652774973
55,18,2,0,7,9,0.44327015185761587,0.30317160504021345
55,19,1,0,0,1,0.004109170649062416,0.0028104393130005973
55,20,1,0,19,20,0.010645492352200728,0.0072809120788640365
55,21,1,0,20,21,0.685716610859153,0.46899121144453176
55,22,1,1,23,25,1.2681149389619728,0.8673185862152657
55,23,1,1,24,26,2.1683533379841737,1.4830305154002932
55,24,1,1,21,23,1.278427102864618,0.8743715205685062
55,25,1,1,22,24,1.0366371965006185,0.7090009588744655
55,26,1,2,19,22,1.021729953933735,0.6988052517266096
55,27,1,1,27,29,1.3041733226667211,0.8919804724647957
55,28,1,1,26,28,1.1854239894325669,0.810762673785633
55,29,1,0,2,3,0.47872438114117943,0.327420283983104
55,30,1,1,20,22,3.3923225649003164,2.320155942160788
55,31,0,0,1,1,0.06461965629663921,0.044196174352140634
55,32,2,1,3,6,0.818781207554619,0.5599998371892024
55,33,1,0,4,5,1.0224869641402452,0.6993230037078285
55,34,0,1,1,2,0.2727496308175524,0.1865452546320874
55,35,2,0,3,5,0.49826125037238567,0.3407823927952221
55,36,1,0,1,2,0.5289005101937014,0.3617379061279947
55,37,0,0,5,5,0.4689334101812144,0.32072381599762106
55,38,1,1,31,33,2.0402688396799196,1.3954279940734242
55,39,1,1,29,31,0.9253805106582766,0.6329077054105778
55,40,0,0,2,2,0.6726695365120604,0.4600677536969016
55,41,2,0,4,6,1.316582340895036,0.9004675360703324
55,42,2,1,6,9,0.252755730960957,0.1728705628326622
55,43,1,1,25,27,0.8456024437567284,0.5783440392395316
55,44,1,0,3,4,0.8704741126547669,0.5953548479940746
55,45,1,0,6,7,1.5954633110333818,1.0912062785227505
55,46,1,0,7,8,0.707688883306468,0.4840189977196001
55,47,1,0,11,12,2.770764603559854,1.8950456026185942
55,48,1,2,20,23,1.0416764060903345,0.7124474919943833
55,49,1,1,28,30,2.5430176514350435,1.7392796239499604
55,50,1,0,9,10,2.2406551746754375,1.5324808647756933
55,51,2,1,2,5,0.793473814592797,0.5426910179252257
55,52,1,1,30,32,2.180877804921679,1.4915965393651465
55,53,0,0,6,6,0.35027355322019604,0.23956721400681186
55,54,0,1,2,3,0.35050161647227623,0.23972319631668332
55,56,1,0,5,6,1.5466178025675685,1.0577987252766603
55,57,2,0,5,7,3.7568204641691354,2.569451800887161
55,58,0,0,7,7,0.2451102938112898,0.16764151810184708
55,59,2,2,7,11,1.1999221690415858,0.8206786051060877
55,60,0,0,1,1,0.1536590742882148,0.10509407860133833
55,61,1,0,8,9,1.455433154536521,0.9954336055347845
55,62,1,1,7,9,0.9442986815621424,0.6458466597103754
55,63,2,2,8,12,1.3921467459855932,0.9521492969089729
55,64,1,0,18,19,1.9708494232131468,1.3479490564030467
55,65,1,0,17,18,1.5688153621841547,1.072980595178647
55,66,1,0,16,17,1.5929494788259408,1.089486960084688
55,67,1,0,15,16,1.1919184349879242,0.8152045056450821
55,68,1,0,14,15,1.0966615765679075,0.7500542253086763
55,69,1,0,13,14,0.8501505156351398,0.581454662062742
55,70,0,0,2,2,0.6366891602145381,0.4354592200829024
55,71,0,0,3,3,0.44103889411530245,0.30164555148537614
55,72,0,0,4,4,0.15013015186830392,0.10268049611755668
55,73,1,0,12,13,2.7708499324155262,1.8951039627089865
55,74,1,0,10,11,2.6450469029154187,1.8090618364511375
55,75,2,0,4,6,0.02758749425697097,0.018868279034520017
55,76,2,0,5,7,0.29914045656698135,0.20459508038115112
55,77,2,1,8,11,2.0345800101989684,1.3915371578479028
55,78,2,1,4,7,4.457001196921304,3.0483356501089625
56,0,2,0,0,2,0.0005573150184152569,0.0003811718157378717
56,1,1,0,6,7,0.6369186905872231,0.4356162058199315
56,2,1,1,5,7,2.7754330381730914,1.8982385467155278
56,3,1,1,4,6,2.86160391638821,1.9571745326977141
56,4,1,1,5,7,2.8949517872830386,1.9799825821490262
56,5,1,0,9,10,0.09036793230395217,0.06180653257599623
56,6,1,0,8,9,0.08367872707051865,0.057231496159569864
56,7,1,1,7,9,0.19818274487782597,0.13554574023108418
56,8,1,0,3,4,2.300848747457704,1.5736498494163882
56,9,1,0,2,3,4.498997873669641,3.077058991490717
56,10,1,0,1,2,4.436249303172259,3.0341425335430117
56,11,1,0,1,2,0.07499084505823048,0.05128947835614363
56,12,1,0,2,3,0.0011071034844668693,0.0007571958971856205
56,13,1,0,0,1,0.0005742512824361989,0.0003927552583069149
56,14,0,1,14,15,0.044080787061733136,0.03014875445354645
56,15,1,1,1,3,0.33441551699105343,0.22872121800137965
56,16,1,2,5,8,6.664650736868695,4.55824253553157
56,17,1,2,5,8,6.372785630649667,4.358623381530699
56,18,1,0,7,8,0.12789004312129054,0.08746952502725253
56,19,0,0,5,5,0.020613912785929726,0.014098745424836837
56,20,0,0,14,14,0.0016623953714064036,0.0011369840059129211
56,21,0,0,15,15,0.33224004914384125,0.227233321565789
56,22,0,1,18,19,0.46655077488780733,0.3190942287964514
56,23,0,1,19,20,0.9671047264295946,0.6614446989605018
56,24,0,1,16,17,0.3040598133024796,0.20795964095671965
56,25,0,1,17,18,0.31940106369187726,0.21845218480246775
56,26,0,2,14,16,0.15422046108504525,0.10547803528222523
56,27,0,1,22,23,0.485166244417542,0.3318261525505229
56,28,0,1,21,22,0.3703648726443814,0.25330853525679853
56,29,0,0,3,3,0.30270947528047687,0.20703608645217697
56,30,0,1,15,16,1.4851238401820848,1.0157403480126794
56,31,0,1,13,14,0.9394445491234378,0.642526708848914
56,32,1,1,3,5,1.1055648336419575,0.7561435474205166
56,33,0,0,1,1,0.12717495581974897,0.0869804459317084
56,34,0,2,11,13,1.4093561374692423,0.9639195431481988
56,35,1,0,3,4,0.643141151044003,0.43987201532137343
56,36,0,0,4,4,0.5881558828630604,0.40226521518352526
56,37,0,1,7,8,0.8467741935483871,0.5791454495387678
56,38,0,1,26,27,0.9192674254093208,0.6287267023385079
56,39,0,1,24,25,0.28457313169719767,0.1946318576299537
56,40,0,1,14,15,1.3222293706199217,0.9043297836370339
56,41,1,0,4,5,1.6320757761707136,1.1162471249989854
56,42,1,1,6,8,1.3018571202675129,0.8903963215897068
56,43,0,1,20,21,0.2121117068435914,0.14507235901650972
56,44,0,0,2,2,0.27778143032151903,0.18998671967426362
56,45,0,0,1,1,0.13949275362318841,0.09540511994817383
56,46,0,0,2,2,0.17267181459507383,0.11809771300100963
56,47,0,0,6,6,1.2870423660960817,0.880263871250773
56,48,0,2,15,17,0.18485284038831173,0.12642884273148244
56,49,0,1,23,24,1.136887309763831,0.7775663418945113
56,50,0,0,4,4,0.7216008509614968,0.4935339933618003
56,51,1,1,2,4,1.3060223751699067,0.8932451193462634
56,52,0,1,25,26,0.6603544502765163,0.4516449342388529
56,53,0,1,6,7,1.0353549040531864,0.708123943677774
56,54,0,2,12,14,1.175422488665035,0.8039222153703831
56,55,0,1,12,13,1.8278210393980354,1.2501257662360528
56,57,1,0,5,6,2.83494268019655,1.9389397615661403
56,58,0,1,5,6,1.9534313725490196,1.3360360991367264
56,59,1,2,7,10,0.31835277891616437,0.21773521756102315
56,60,0,1,11,12,0.6368573420518416,0.4355742469064776
56,61,0,0,3,3,0.4269307768613393,0.2919964006592826
56,62,0,1,2,3,0.21454738057687095,0.14673822149783877
56,63,1,2,8,11,0.43472435033130474,0.2973267622186759
56,64,0,0,13,13,0.19341231270030776,0.13228303559389434
56,65,0,0,12,12,0.0548268314360086,0.03749843840390845
56,66,0,0,11,11,0.20613207822527135,0.14098263269913114
56,67,0,0,10,10,0.37896665111359074,0.259191663127651
56,68,0,0,9,9,0.6992274344603769,0.4782318473398943
56,69,0,0,8,8,0.948490005649151,0.6487132873084147
56,70,0,1,10,11,1.1668536126337041,0.7980615908981006
56,71,0,1,9,10,1.371960055589321,0.9383427473313836
56,72,0,1,8,9,1.6572769353001258,1.1334832863559356
56,73,0,0,7,7,1.299965116729881,0.8891022986404021
56,74,0,0,5,5,0.8578865821045938,0.586745692100324
56,75,1,0,4,5,0.14191215674298596,0.09705985425409193
56,76,1,0,5,6,1.7784058030312155,1.216328551467614
56,77,1,1,8,10,0.6384830383634148,0.43668613084006114
56,78,1,1,4,6,5.426610073131581,3.71149304527761
57,0,1,0,0,1,0.0009301734135642689,0.0006361857787496515
57,1,0,0,11,11,1.9119229953189567,1.3076467268888627
57,2,0,1,10,11,6.839735772378695,4.677990754561531
57,3,0,1,9,10,7.337998218889291,5.018773965447345
57,4,0,1,10,11,7.835827630750614,5.359261005230485
57,5,0,0,14,14,1.3947842307371625,0.953953186663452
57,6,0,0,13,13,2.358194686790344,1.6128712145300934
57,7,0,1,12,13,0.8106211836595515,0.5544188443543212
57,8,0,0,8,8,5.882194030425233,4.023086593781761
57,9,0,0,7,7,8.904028989905997,6.0898500584390565
57,10,0,0,6,6,7.908024185427051,5.408639347688021
57,11,0,0,4,4,0.04005025553455883,0.027392099833022574
57,12,0,0,3,3,0.001449090190587613,0.0009910953784896205
57,13,0,0,5,5,0.009282549517611842,0.00634873659849671
57,14,0,2,24,26,0.38319304775540036,0.2620822783609672
57,15,0,1,4,5,0.0632406399467287,0.04325300550030835
57,16,0,2,10,12,16.453271373465185,11.253103033334623
57,17,0,2,10,12,17.27565764616323,11.815568530305399
57,18,0,0,12,12,0.5222629905475359,0.3571982197173917
57,19,0,1,5,6,0.055083251716972786,0.03767381531078791
57,20,0,1,24,25,0.015156059752402726,0.01036588396932544
57,21,0,1,25,26,0.5074117826338015,0.3470408370893842
57,22,0,2,28,30,1.202300705748,0.8223053891065637
57,23,0,2,29,31,1.7454676977618953,1.1938007584284587
57,24,0,2,26,28,1.5481506094059627,1.058847078086939
57,25,0,2,27,29,1.1022925505950083,0.7539054916900957
57,26,0,3,24,27,1.4449981844578281,0.9882966787328191
57,27,0,2,32,34,1.2028399734528743,0.8226742175849713
57,28,0,2,31,33,1.2337067459771163,0.8437853366832667
57,29,0,1,7,8,1.5424113005689466,1.0549217168492198
57,30,0,2,25,27,2.8417075181222797,1.943566526447975
57,31,0,2,13,15,2.14464660883368,1.46681645926164
57,32,0,1,4,5,2.779735734843746,1.9011813468345449
57,33,0,1,9,10,2.0883544933262455,1.4283158497846002
57,34,0,3,11,14,3.766687983899855,2.5762006238836817
57,35,0,0,2,2,0.6535111268060716,0.4469644897026042
57,36,0,1,6,7,2.299799112680339,1.572931958850497
57,37,0,2,7,9,2.8033445908238153,1.917328463284064
57,38,0,2,36,38,1.5531097474743465,1.0622388468345239
57,39,0,2,34,36,1.8927421889489229,1.294528144848544
57,40,0,2,14,16,3.941718900610837,2.6959118287291943
57,41,0,0,1,1,1.6053240740740742,1.09795048032709
57,42,0,1,11,12,3.456627200746165,2.3641366604185214
57,43,0,2,30,32,0.9949799773272607,0.6805097871919754
57,44,0,1,8,9,2.1688832970100207,1.4833929772710015
57,45,0,1,11,12,2.501837174149575,1.7111145166386796
57,46,0,1,12,13,0.8713371588796408,0.5959451225887487
57,47,0,1,16,17,2.2778048778875672,1.557889151578651
57,48,0,3,25,28,1.4252771171974776,0.9748085889316656
57,49,0,2,33,35,1.9973523610223691,1.3660755604327695
57,50,0,1,14,15,2.4070919141179337,1.646314140539881
57,51,0,1,3,4,3.1239338459082497,2.1365933035068596
57,52,0,2,35,37,2.30293378107144,1.5750758939731673
57,53,0,2,6,8,3.033676106228297,2.0748621364264683
57,54,0,3,12,15,3.34557089890165,2.288180458226845
57,55,0,2,12,14,4.269114163828563,2.919831591917228
57,56,0,1,10,11,2.7259064232659136,1.8643651553520582
57,58,0,2,5,7,4.7537824637248915,3.2513171786997095
57,59,0,2,12,14,1.477518980077126,1.0105390556755693
57,60,0,2,11,13,1.7525123395263824,1.1986188932424602
57,61,0,1,13,14,1.645988089745635,1.125762357230743
57,62,0,2,12,14,1.1962703749225572,0.8181809853595229
57,63,0,2,13,15,1.5763455721420325,1.078130831055465
57,64,0,1,23,24,3.021877110460821,2.066792293533375
57,65,0,1,22,23,2.7191379314201574,1.8597358913964768
57,66,0,1,21,22,3.2131516166442204,2.1976131909023504
57,67,0,1,20,21,2.92777606916609,2.002432526457421
57,68,0,1,19,20,3.5121936202079014,2.402140935021616
57,69,0,1,18,19,3.678122399128656,2.5156267946423343
57,70,0,2,10,12,3.830805236235842,2.6200531824645124
57,71,0,2,9,11,3.979755475299459,2.7219266852456006
57,72,0,2,8,10,4.000668346941824,2.7362299015466434
57,73,0,1,17,18,2.2353213282012545,1.5288328167628968
57,74,0,1,15,16,2.805000808561945,1.9184612221397206
57,75,0,0,9,9,0.37592985501690795,0.2571146670949768
57,76,0,0,10,10,4.376232629746231,2.993094538013667
57,77,0,1,13,14,2.2769208086844084,1.557284498460987
57,78,0,1,5,6,13.9650006025802,9.551267165923989
58,0,3,0,0,3,0.0009038577688227299,0.0006181873725395192
58,1,2,0,6,8,1.7996143699633649,1.2308340065506531
58,2,2,1,5,8,0.15975995931010198,0.10926673741109612
58,3,2,1,4,7,0.24129709558534826,0.16503350711430254
58,4,2,1,5,8,0.4491224206223616,0.3071742244520988
58,5,2,0,9,11,0.6640251495626421,0.45415548404585226
58,6,2,0,8,10,1.3222001480765389,0.9043097970772718
58,7,2,1,7,10,0.6794912481336124,0.46473341695611353
58,8,2,0,3,5,5.917494025108102,4.04722978501868
58,9,2,0,2,4,10.026609080865464,6.857631075356457
58,10,2,0,1,3,9.350572377128131,6.3952603705408135
58,11,2,0,1,3,0.12474168891540637,0.0853162295846584
58,12,2,0,2,4,0.0015996526620783583,0.0010940715566721136
58,13,2,0,0,2,0.005096950961635124,0.0034860249384590512
58,14,1,1,19,21,0.2751651869369394,0.1881973578082438
58,15,2,1,1,4,0.49292375318493764,0.33713184790192186
58,16,2,2,5,9,0.4417452760232857,0.30212867658621406
58,17,2,2,5,9,1.012851306261211,0.6927327610475388
58,18,2,0,7,9,0.43957006012092054,0.3006409524665877
58,19,1,0,0,1,0.004580458682783503,0.003132773557751106
58,20,1,0,19,20,0.01069247133573378,0.0073130430350793075
58,21,1,0,20,21,0.6866067074585283,0.4695999869588373
58,22,1,1,23,25,1.2684733301601654,0.8675637054373315
58,23,1,1,24,26,2.170225938566323,1.4843112678301835
58,24,1,1,21,23,1.2792202748187633,0.8749140051310317
58,25,1,1,22,24,1.0371566671257582,0.7093562472748571
58,26,1,2,19,22,1.022794525784778,0.6995333584024341
58,27,1,1,27,29,1.3076203106162396,0.8943380164249076
58,28,1,1,26,28,1.189319238781628,0.8134268030806867
58,29,1,0,2,3,0.4680861054707435,0.3201443077046419
58,30,1,1,20,22,3.38942535742648,2.318174416817165
58,31,0,0,8,8,0.1807879785101976,0.12364870810096375
58,32,2,1,3,6,0.9443278626762917,0.6458666179348946
58,33,1,0,4,5,1.0114326069330308,0.6917624512926606
58,34,0,1,6,7,0.28331035446034164,0.19376818972878435
58,35,2,0,3,5,0.5421166182879342,0.370776973357138
58,36,1,0,1,2,0.5096437346403355,0.3485673654815125
58,37,0,0,2,2,0.43870967741935485,0.3000524995705616
58,38,1,1,31,33,2.049336161444169,1.4016295271140846
58,39,1,1,29,31,0.945663021050689,0.6467797904227165
58,40,0,0,9,9,0.7561929740161021,0.517193040613829
58,41,2,0,4,6,1.4317017350378622,0.9792026626004585
58,42,2,1,6,9,0.17411347071915792,0.11908372390028403
58,43,1,1,25,27,0.849198585390984,0.580803595847709
58,44,1,0,3,4,0.8575510406897594,0.5865162008321515
58,45,1,0,6,7,1.5833333333333333,1.0829100627883625
58,46,1,0,7,8,0.7040012626251303,0.4814968746394525
58,47,1,0,11,12,2.762965445336984,1.889711421405442
58,48,1,2,20,23,1.0471108038933723,0.7161643114045547
58,49,1,1,28,30,2.5495003762242017,1.7437134394710978
58,50,1,0,9,10,2.2310638215750864,1.525920924067403
58,51,2,1,2,5,0.9448714822956377,0.6462384228756015
58,52,1,1,30,32,2.1982538524929276,1.503480768901817
58,53,0,0,1,1,0.3064019313670252,0.20956151667482584
58,54,0,1,7,8,0.35578850015302443,0.24333912444637207
58,55,0,0,7,7,0.22728409062501417,0.15544940769444002
58,56,1,0,5,6,1.5326923076923078,1.0482744777842006
58,57,2,0,5,7,3.8790864903995113,2.653074817818963
58,59,2,2,7,11,1.1887648979226664,0.8130476654210755
58,60,0,0,6,6,0.1576694940625461,0.10783697792531442
58,61,1,0,8,9,1.448720217833485,0.9908423381411559
58,62,1,1,7,9,0.9390913491154473,0.6422851401060742
58,63,2,2,8,12,1.3809446838865955,0.9444877227378246
58,64,1,0,18,19,1.9630487684098967,1.3426138516139239
58,65,1,0,17,18,1.5615048100241369,1.0679805927584642
58,66,1,0,16,17,1.5838229374704904,1.083244924207464
58,67,1,0,15,16,1.182905443941586,0.8090401317293552
58,68,1,0,14,15,1.0843919086489753,0.7416624693993186
58,69,1,0,13,14,0.8349318347543255,0.5710459487986167
58,70,0,0,5,5,0.6170128999350213,0.4220017757114929
58,71,0,0,4,4,0.41323590240099334,0.28262988443082027
58,72,0,0,3,3,0.0584819535317425,0.039998334297502346
58,73,1,0,12,13,2.76486232348377,1.891008778310519
58,74,1,0,10,11,2.636402628914531,1.803149644050467
58,75,2,0,4,6,0.01807506746664428,0.012362319439078517
58,76,2,0,5,7,0.0759256756772096,0.05192884939885637
58,77,2,1,8,11,2.020064316497248,1.3816092478828839
58,78,2,1,4,7,5.068968775248516,3.46688671242734
59,0,3,0,0,3,0.0006785611415375016,0.00046409727687670674
59,1,2,0,1,3,0.21493217077867824,0.147001396138849
59,2,2,1,2,5,3.763914514057911,2.5743037280516736
59,3,2,1,3,6,3.9394103292199842,2.694332897030361
59,4,2,1,4,7,4.070266812055059,2.7838312983207993
59,5,2,0,2,4,0.3423018135538611,0.2341149968893782
59,6,2,0,1,3,0.4383146945543851,0.29978235372691653
59,7,1,0,0,1,0.022432430937359697,0.015342508544129559
59,8,2,0,4,6,0.9910029146574212,0.6777897022327064
59,9,2,0,5,7,2.5000096450431233,1.7098645905379966
59,10,2,0,6,8,2.660500988217569,1.8196315529679088
59,11,2,0,8,10,0.06437839400434994,0.04403116464850393
59,12,2,0,9,11,0.0012989075222646234,0.0008883789641001221
59,13,2,0,7,9,0.0023727161455985714,0.001622803067500491
59,14,2,2,26,30,0.062005555535238614,0.04240827791866899
59,15,2,1,8,11,0.30751278259280873,0.2103212758141911
59,16,2,2,2,6,9.033367927363035,6.178310544891212
59,17,2,2,4,8,8.954586986521129,6.124428856305759
59,18,2,0,0,2,0.014641689962819194,0.010014084250714279
59,19,2,1,7,10,0.029520884238504845,0.020190607960602486
59,20,2,1,26,29,0.002746298646075495,0.0018783122774256062
59,21,2,1,27,30,0.21205122179149383,0.14503099067657407
59,22,2,2,30,34,0.20928844424038798,0.14314140776414985
59,23,2,2,31,35,0.5625131362612636,0.38472703307871403
59,24,2,2,28,32,0.15660044909063287,0.10710581188889877
59,25,2,2,29,33,0.11990783147371675,0.0820101456694857
59,26,2,3,26,31,0.22539129212971218,0.15415484103924432
59,27,2,2,34,38,0.23739946702645404,0.16236775057486813
59,28,2,2,33,37,0.1699928511568779,0.11626545418096891
59,29,2,1,9,12,0.5813996112578449,0.39764430917833427
59,30,2,2,27,31,0.8297608152125615,0.5675092651586261
59,31,2,2,15,19,1.277781616708656,0.8739300447030229
59,32,2,1,10,13,1.617731873433164,1.1064367102953114
59,33,2,1,11,14,0.5408402382083882,0.36990400188424344
59,34,2,3,13,18,2.012616456257873,1.376515334535856
59,35,2,0,10,12,0.7351459435551819,0.5027980673014436
59,36,2,1,8,11,0.9846028320651968,0.6734124092799929
59,37,2,2,9,13,1.310548137381997,0.8963404836249537
59,38,2,2,38,42,0.5635426728891051,0.38543117765195534
59,39,2,2,36,40,0.6491105619268094,0.443954753288053
59,40,2,2,16,20,2.0205512529669174,1.3819422847689535
59,41,2,0,11,13,1.8620624181005876,1.2735449242744155
59,42,2,1,5,8,1.8340112850497912,1.254359542640738
59,43,2,2,32,36,0.13359029848747336,0.09136817590925427
59,44,2,1,10,13,0.6890259054661313,0.47125458097966527
59,45,2,1,13,16,0.3893073370596948,0.26626410493849534
59,46,2,1,14,17,0.039061205534107336,0.02671564581317641
59,47,2,1,18,21,0.7635043925715126,0.5221936355992468
59,48,2,3,27,32,0.24927101328692855,0.1704872138841263
59,49,2,2,35,39,0.6756421737419709,0.4621008687090844
59,50,2,1,16,19,0.20511459819579184,0.14028673415432508
59,51,2,1,9,12,1.8727301075049643,1.280841017876121
59,52,2,2,37,41,0.4121213413547034,0.2818675879849555
59,53,2,2,8,12,1.519263033533865,1.0390896170754926
59,54,2,3,14,19,1.7240727019440372,1.1791677965772123
59,55,2,2,14,18,2.4871114049225596,1.7010429269471636
59,56,2,1,12,15,0.5583417968683498,0.38187407387625605
59,57,2,0,12,14,2.6949946196606778,1.8432232375522388
59,58,2,2,7,11,2.6572391835918423,1.8174006638824043
59,60,2,2,13,17,0.9208137291957763,0.6297842862946008
59,61,2,1,15,18,0.08986255850705156,0.061460885605385776
59,62,2,2,14,18,0.06492844122061488,0.04440736570039995
59,63,0,0,1,1,0.09050751337499148,0.061901998100040385
59,64,2,1,25,28,0.4875073586571776,0.33342734170941035
59,65,2,1,24,27,0.5752276426079613,0.39342303320475114
59,66,2,1,23,26,0.852783744448684,0.5832556409973597
59,67,2,1,22,25,0.9459418101570123,0.6469704663355375
59,68,2,1,21,24,1.3461283532291215,0.9206753302209748
59,69,2,1,20,23,1.5943563772422595,1.0904491986861737
59,70,2,2,12,16,1.8119556272583117,1.239274725526753
59,71,2,2,11,15,2.0164591000801173,1.3791434846386899
59,72,2,2,10,14,2.2579383495298933,1.544301574649475
59,73,2,1,19,22,0.7833492557248246,0.535766394759276
59,74,2,1,17,20,0.26373313370967727,0.18037848276942212
59,75,2,0,3,5,0.1995406791947194,0.13647449016984387
59,76,2,0,2,4,2.415442618256918,1.652025547830497
59,77,1,0,1,2,0.1409995868350483,0.09643570827326864
59,78,2,1,11,14,8.014848292792463,5.481700969255003
60,0,3,0,0,3,0.000759601842466218,0.0005195245130016305
60,1,2,0,6,8,1.5865341877095636,1.0850992653653353
60,2,2,1,5,8,0.6366298376249113,0.43541864680126613
60,3,2,1,4,7,0.5678534404614394,0.3883794978092748
60,4,2,1,5,8,0.48417692346669766,0.33114951321599867
60,5,2,0,9,11,0.5328722127778673,0.364454325093129
60,6,2,0,8,10,1.090225222414061,0.7456521246681269
60,7,2,1,7,10,0.5915787968740323,0.40460629393712993
60,8,2,0,3,5,5.2535426850651605,3.5931247824917407
60,9,2,0,2,4,9.009859354419454,6.16223201634233
60,10,2,0,1,3,8.445619819290476,5.776324224501783
60,11,2,0,1,3,0.1128655570863024,0.07719363000692923
60,12,2,0,2,4,0.0013701265380424012,0.0009370887254775781
60,13,2,0,0,2,0.004063832553907116,0.0027794306312292297
60,14,1,1,19,21,0.22956636448519158,0.1570103533760558
60,15,2,1,1,4,0.45071058412176235,0.308260438074112
60,16,2,2,5,9,1.561738703425697,1.0681405625594134
60,17,2,2,5,9,1.1143318792846602,0.7621397086504583
60,18,2,0,7,9,0.38253067764391896,0.26162925482895866
60,19,1,0,0,1,0.0007680491551459293,0.0005253019950465014
60,20,1,0,19,20,0.008873989743859861,0.006069304920446254
60,21,1,0,20,21,0.6185362507008966,0.4230436611052967
60,22,1,1,23,25,1.1151885698718484,0.7627256363499713
60,23,1,1,24,26,1.939734818527401,1.3266684341837567
60,24,1,1,21,23,1.09141458431173,0.7464655806474634
60,25,1,1,22,24,0.8995021297017336,0.6152083627917285
60,26,1,2,19,22,0.8534056682304736,0.5836810015373096
60,27,1,1,27,29,1.147875547509156,0.7850816723534946
60,28,1,1,26,28,1.0292409934361557,0.7039423761008237
60,29,1,0,2,3,0.32768749067534847,0.2241196301698122
60,30,1,1,20,22,3.028822457913221,2.071542516678069
60,31,0,0,2,2,0.20235798967108024,0.13840137050553877
60,32,2,1,3,6,0.6775030902586945,0.4633736299019069
60,33,1,0,4,5,0.8011471367319973,0.5479391344049458
60,34,0,1,0,1,0.05625,0.03847180486221815
60,35,2,0,3,5,0.5204068891314403,0.35592875177988925
60,36,1,0,1,2,0.3130360378443783,0.21409886867183744
60,37,0,0,4,4,0.21787928762281655,0.149017056656784
60,38,1,1,31,33,1.8270529837319947,1.249600459787924
60,39,1,1,29,31,0.7251250424309548,0.49594434014420175
60,40,0,0,3,3,0.37647854723079033,0.25748994140221054
60,41,2,0,4,6,1.3595458411244012,0.9298521297951682
60,42,2,1,6,9,0.14665918424609875,0.10030655142343127
60,43,1,1,25,27,0.7232861178825332,0.4946866202085001
60,44,1,0,3,4,0.6489741457274801,0.44386145235648605
60,45,1,0,6,7,1.3157961755984042,0.8999298436635508
60,46,1,0,7,8,0.6051526896393816,0.4138900655582712
60,47,1,0,11,12,2.487347957730439,1.701204715630974
60,48,1,2,20,23,0.8731595947753299,0.5971915652225772
60,49,1,1,28,30,2.2755725058964473,1.5563623359409224
60,50,1,0,9,10,1.9498563672938112,1.3335909986112189
60,51,2,1,2,5,0.6781722013782504,0.4638312639005326
60,52,1,1,30,32,1.8862110168271207,1.2900611941038056
60,53,0,0,5,5,0.11004745451450651,0.07526620792294975
60,54,0,1,1,2,0.05495688685055647,0.03758738891999309
60,55,0,0,1,1,0.35620967221358885,0.24362718221219343
60,56,1,0,5,6,1.2492201709478432,0.8543956381627063
60,57,2,0,5,7,3.57512517263382,2.445182542214619
60,58,0,0,6,6,0.3941737351563653,0.2695924448132861
60,59,2,2,7,11,1.02985746028475,0.7043640044084352
60,61,1,0,8,9,1.2584598666739153,0.8607150652019901
60,62,1,1,7,9,0.8043980347732752,0.5501625640062083
60,63,2,2,8,12,1.207800727095278,0.8260670912934175
60,64,1,0,18,19,1.6286094259547537,1.1138763383484516
60,65,1,0,17,18,1.2689316492694074,0.867877169674405
60,66,1,0,16,17,1.249563460125216,0.854630428460363
60,67,1,0,15,16,0.8906014422597114,0.6091207981622341
60,68,1,0,14,15,0.750760270484024,0.5134773799887554
60,69,1,0,13,14,0.5022519837350733,0.3435118277318703
60,70,0,0,1,1,0.28694107437907235,0.1962513959194115
60,71,0,0,2,2,0.09954956750436497,0.0680862495137092
60,72,0,0,3,3,0.3146040280168778,0.21517128488414464
60,73,1,0,12,13,2.4901677327783047,1.7031332815935847
60,74,1,0,10,11,2.303248047968768,1.57529083467981
60,75,2,0,4,6,0.017174396307211744,0.011746311526354672
60,76,2,0,5,7,0.39088001879654544,0.2673397299143264
60,77,2,1,8,11,1.7662360326940252,1.2080051198297403
60,78,2,1,4,7,3.6627456228743798,2.5051099531229655
61,0,2,0,0,2,0.0006581638114071969,0.0004501466616858921
61,1,1,0,6,7,0.16345526151314252,0.11179411421575922
61,2,1,1,5,7,3.9306184354020197,2.6883197410599777
61,3,1,1,4,6,4.1216055126414695,2.818944053357959
61,4,1,1,5,7,4.269267026062732,2.91993614100245
61,5,1,0,9,10,0.38901912021381685,0.2660669809873377
61,6,1,0,8,9,0.5212277839544482,0.3564901972099899
61,7,1,1,7,9,0.03268796741857406,0.022356712957687572
61,8,1,0,3,4,0.8085544697659599,0.553005329445516
61,9,1,0,2,3,2.202275934147094,1.5062316442891768
61,10,1,0,1,2,2.3911846562648926,1.6354344797396112
61,11,1,0,1,2,0.059290007263542124,0.040550997150622034
61,12,1,0,2,3,0.0012593805942742275,0.0008613447905810206
61,13,1,0,0,1,0.002584602793409411,0.001767721498922503
61,14,0,1,11,12,0.0664977132063803,0.045480658600170844
61,15,1,1,1,3,0.2897312027487288,0.1981596852381308
61,16,1,2,5,8,9.436137686810449,6.453782182044341
61,17,1,2,5,8,9.395132377816408,6.425736879894409
61,18,1,0,7,8,0.018843943179190532,0.012888186752436352
61,19,0,0,8,8,0.030799303579754432,0.021064974172667193
61,20,0,0,11,11,0.002917007898121057,0.0019950677091211096
61,21,0,0,12,12,0.18560962452641494,0.12694644009475226
61,22,0,1,15,16,0.141417748871736,0.09672170735373509
61,23,0,1,16,17,0.47042953625030376,0.32174708124525275
61,24,0,1,13,14,0.1431300330852335,0.09789281249382989
61,25,0,1,14,15,0.060931268329138186,0.04167352649184101
61,26,0,2,11,13,0.24670670345749465,0.16873337161987298
61,27,0,1,19,20,0.1648501265880955,0.11274812269527414
61,28,0,1,18,19,0.10649991034164197,0.07283988921790895
61,29,0,0,6,6,0.6247589690457875,0.4272996469875578
61,30,0,1,12,13,0.6926281480828496,0.47371831031329636
61,31,0,1,16,17,1.3221042673571133,0.9042442201114446
61,32,1,1,3,5,1.654126647425389,1.1313286683936832
61,33,0,0,4,4,0.6028571428571429,0.41232004195189986
61,34,0,2,14,16,2.101158121462754,1.4370728041525322
61,35,1,0,3,4,0.7315021626581361,0.5003059281435444
61,36,0,0,7,7,1.0468328621135705,0.7159742150149441
61,37,0,1,10,11,1.3838747274180074,0.9464917060796608
61,38,0,1,23,24,0.4678881020010947,0.32000888457848425
61,39,0,1,21,22,0.6825339723829065,0.46681446750844036
61,40,0,1,17,18,2.1051566497671406,1.4398075703865305
61,41,1,0,4,5,1.8486883424564273,1.2643978162140659
61,42,1,1,6,8,1.9185185185185185,1.3121576901154897
61,43,0,1,17,18,0.1156327190389159,0.07908621160093991
61,44,0,0,5,5,0.7521381010952247,0.5144197378626629
61,45,0,0,2,2,0.4637822688057869,0.31720072789427617
61,46,0,0,1,1,0.04933333333333333,0.03374119774582688
61,47,0,0,3,3,0.6703703703703704,0.4584952546542541
61,48,0,2,12,14,0.2588620813188217,0.1770469596217841
61,49,0,1,20,21,0.5614218692802432,0.3839806684503335
61,50,0,0,1,1,0.09090909090909091,0.06217665432277681
61,51,1,1,2,4,1.9163462141533818,1.3106719573219452
61,52,0,1,22,23,0.3192491190277586,0.21834826328303972
61,53,0,1,9,10,1.5959604838821777,1.0915463165106918
61,54,0,2,15,17,1.8041460292497578,1.2339334040931982
61,55,0,1,15,16,2.580086046678378,1.764632300720754
61,56,0,0,3,3,0.6403961652920089,0.4379946009889239
61,57,1,0,5,6,2.5677414200031903,1.7561892772799588
61,58,0,1,8,9,2.769612181152251,1.8942574111522097
61,59,1,2,7,10,0.07685613556524147,0.05256523110986941
61,60,0,1,14,15,0.9623516627506411,0.6581938733897571
61,62,0,1,1,2,0.08818650409292929,0.06031455959012227
61,63,1,2,8,11,0.06881117150770678,0.04706293266817993
61,64,0,0,10,10,0.5632656707807622,0.38524172394424705
61,65,0,0,9,9,0.6484757377656493,0.4435205696213868
61,66,0,0,8,8,0.9415225140438919,0.6439479188210073
61,67,0,0,7,7,1.026647295418175,0.7021684339849255
61,68,0,0,6,6,1.440901380146703,0.9854946972925293
61,69,0,0,5,5,1.6907284994159308,1.1563622560803664
61,70,0,1,13,14,1.9093643533221325,1.3058967611001677
61,71,0,1,12,13,2.114635824429761,1.4462907874154234
61,72,0,1,11,12,2.3506241783359965,1.6076934167707435
61,73,0,0,4,4,0.6879815080097151,0.47054027244381036
61,74,0,0,2,2,0.11805060555515492,0.08073990863617078
61,75,1,0,4,5,0.20875391793683604,0.14277582213492368
61,76,1,0,5,6,2.5213701192764426,1.724473941586329
61,77,1,1,8,10,0.08737659397334457,0.05976062707320497
61,78,1,1,4,6,8.18824679775317,5.600295697188312
62,0,3,0,0,3,0.0006143732966278948,0.0004201964369853518
62,1,2,0,6,8,0.29678722666556273,0.2029856047978033
62,2,2,1,5,8,3.5939848286132854,2.4580814756299176
62,3,2,1,4,7,3.7544051261471063,2.5677998468772087
62,4,2,1,5,8,3.868724276223656,2.645987651921825
62,5,2,0,9,11,0.29982417231131897,0.20506270311354907
62,6,2,0,8,10,0.3662504601518986,0.25049451082064794
62,7,2,1,7,10,0.06142776297635423,0.04201310062842469
62,8,2,0,3,5,1.2375662600175734,0.8464250250570883
62,9,2,0,2,4,2.8683161705643587,1.9617653332817218
62,10,2,0,1,3,2.9851343826411667,2.0416623547816712
62,11,2,0,1,3,0.06330367186844922,0.04329611575439764
62,12,2,0,2,4,0.0011942685443222087,0.000816811846937766
62,13,2,0,0,2,0.0019478061820780606,0.0013321887883791874
62,14,1,1,12,14,0.040963453652583935,0.028016675473861805
62,15,2,1,1,4,0.30078915456625527,0.20572269616256972
62,16,2,2,5,9,8.62840914910996,5.901341743216642
62,17,2,2,5,9,8.514164183026846,5.823204675809704
62,18,2,0,7,9,0.03859309709528871,0.02639548623073041
62,19,1,0,7,8,0.02782998107874333,0.019034126246766876
62,20,1,0,12,13,0.0019124932161596233,0.0013080367255539384
62,21,1,0,13,14,0.22808480915180723,0.1559970536839928
62,22,1,1,16,18,0.2329744934110704,0.15934131997128584
62,23,1,1,17,19,0.6139075345468322,0.41987788217833205
62,24,1,1,14,16,0.08149083373189753,0.055735101393653806
62,25,1,1,15,17,0.11666511948744558,0.07979231486485991
62,26,1,2,12,15,0.14788216864270395,0.10114300328219987
62,27,1,1,20,22,0.2511540205011437,0.1717750838592273
62,28,1,1,19,21,0.15247167883650464,0.10428196755933873
62,29,1,0,5,6,0.5309477756286267,0.3631381193957922
62,30,1,1,13,15,0.922852897926717,0.6311789618767853
62,31,1,1,15,17,1.2103520574874036,0.8278120563598157
62,32,2,1,3,6,1.4873563711875806,1.017267272407209
62,33,1,0,3,4,0.4642879120827103,0.3175465591739151
62,34,1,2,13,16,1.8995487859693887,1.2991834705791592
62,35,2,0,3,5,0.7039234569912801,0.48144366000544964
62,36,1,0,6,7,0.9132231404958677,0.6245927547878943
62,37,1,1,9,11,1.227420414564419,0.8394858430760039
62,38,1,1,24,26,0.5952404308883456,0.4071106436131392
62,39,1,1,22,24,0.5566239726364471,0.3806991796782586
62,40,1,1,16,18,1.8754246020514618,1.282683899092035
62,41,2,0,4,6,1.7800929688628413,1.2174824770612942
62,42,2,1,6,9,1.7388898749652075,1.1893019012719712
62,43,1,1,18,20,0.0857882040823424,0.05867425861219598
62,44,1,0,4,5,0.613960113960114,0.41991384351037725
62,45,1,0,1,2,0.2880491750416515,0.19700927382978375
62,46,1,0,0,1,0.015347819244295118,0.010497036569370989
62,47,1,0,4,5,0.8500020172654187,0.5813530976129239
62,48,1,2,13,16,0.16888137720961677,0.115505269135485
62,49,1,1,21,23,0.7260745906754277,0.49659377720675496
62,50,1,0,2,3,0.2746277428690549,0.18782977659395023
62,51,2,1,2,5,1.732462972588127,1.1849062651098456
62,52,1,1,23,25,0.3289376840679706,0.22497469143631874
62,53,1,1,8,10,1.4326599326599327,0.9798580153459828
62,54,1,2,14,17,1.6208979092279616,1.1086020989403649
62,55,1,1,14,16,2.360746703905356,1.6146166492759384
62,56,1,0,2,3,0.45385022814338083,0.3104077762454282
62,57,2,0,5,7,2.6317948248296257,1.7999981677909502
62,58,1,1,7,9,2.531863931438706,1.7316511130310823
62,59,2,2,7,11,0.07831281287574163,0.05356151564741222
62,60,1,1,13,15,0.8674880767162773,0.593312569026303
62,61,1,0,1,2,0.12436558269515668,0.08505899429376218
62,63,2,2,8,12,0.16094339929856638,0.11007614314091561
62,64,1,0,11,12,0.3489932336086071,0.23869154811777504
62,65,1,0,10,11,0.46006355841688124,0.3146573412201236
62,66,1,0,9,10,0.725721101846857,0.49635201092704406
62,67,1,0,8,9,0.8375991990283244,0.5728702744492074
62,68,1,0,7,8,1.2246980866238428,0.8376239253995453
62,69,1,0,6,7,1.474446521999779,1.0084376688738088
62,70,1,1,12,14,1.693037317585541,1.1579413565618524
62,71,1,1,11,13,1.8982783826196088,1.2983145868499322
62,72,1,1,10,12,2.1486530826181416,1.469556659752687
62,73,1,0,5,6,0.8662477811951991,0.5924642773417093
62,74,1,0,3,4,0.332049538061779,0.22710302280715447
62,75,2,0,4,6,0.1892831159223076,0.12945889954623352
62,76,2,0,5,7,2.304895841932041,1.5764178321519555
62,77,2,1,8,11,0.23465775125438626,0.16049257272294534
62,78,2,1,4,7,7.343241968938453,5.022360392623125
63,0,3,0,0,3,0.000712752076465084,0.0004874819342383201
63,1,2,0,1,3,0.10380116959064327,0.07099410383931094
63,2,2,1,2,5,4.027783764363367,2.754775306840852
63,3,2,1,3,6,4.227274424350697,2.8912155867140545
63,4,2,1,4,7,4.384299467989379,2.998611797155809
63,5,2,0,2,4,0.4128108647909597,0.2823391828487346
63,6,2,0,1,3,0.5616906576033888,0.38416450439553
63,7,1,0,0,1,0.023706190564373265,0.016213687776340007
63,8,2,0,4,6,0.6454705503777526,0.4414651921500702
63,9,2,0,5,7,1.972234448318912,1.3488963349025718
63,10,2,0,6,8,2.191366718814261,1.4987703606716714
63,11,2,0,8,10,0.0614947518443168,0.0420589172089793
63,12,2,0,9,11,0.0013499587699931635,0.0009232951177105248
63,13,2,0,7,9,0.002854227362298861,0.0019521293887069407
63,14,2,2,26,30,0.0805690547958889,0.05510465696072532
63,15,2,1,8,11,0.29948553027140906,0.204831091193948
63,16,2,2,2,6,9.66675646510015,6.611512326682999
63,17,2,2,4,8,9.645561647935917,6.597016275660194
63,18,2,0,0,2,0.015339299776947408,0.010491209737631771
63,19,2,1,7,10,0.03183071472967552,0.021770400812533498
63,20,2,1,26,29,0.0034813253589642407,0.0023810287977238014
63,21,2,1,27,30,0.17974613617373744,0.12293614712202167
63,22,2,2,30,34,0.15067104939572015,0.10305043930200493
63,23,2,2,31,35,0.45540575153456525,0.3114716658874595
63,24,2,2,28,32,0.20969491051188927,0.14341940760557692
63,25,2,2,29,33,0.10606725484278584,0.07254397743258345
63,26,2,3,26,31,0.297182240301498,0.20325577168704093
63,27,2,2,34,38,0.1850769359542734,0.12658211136942318
63,28,2,2,33,37,0.15998318053956656,0.10941940805253728
63,29,2,1,9,12,0.6545224193558808,0.44765615636277983
63,30,2,2,27,31,0.6554936611020501,0.4483204305482494
63,31,2,2,15,19,1.3644917923345457,0.9332348794807631
63,32,2,1,10,13,1.745186544869481,1.1936084658202202
63,33,2,1,11,14,0.6482330772561515,0.44335460361660156
63,34,2,3,13,18,2.1696013778777172,1.4838841037957538
63,35,2,0,10,12,0.7563032805698235,0.517268484030892
63,36,2,1,8,11,1.0888706363241822,0.7447256647264577
63,37,2,2,9,13,1.43273840390598,0.97991168522092
63,38,2,2,38,42,0.47192316231803033,0.3227686366339585
63,39,2,2,36,40,0.744352450783669,0.5090947952935672
63,40,2,2,16,20,2.197905711506942,1.5032426602426632
63,41,2,0,11,13,1.91469750339119,1.3095443328114158
63,42,2,1,5,8,1.9743945608794051,1.3503737291942641
63,43,2,2,32,36,0.16204710611142004,0.11083101590765708
63,44,2,1,10,13,0.7965115988002431,0.5447686897695351
63,45,2,1,13,16,0.5235757980054931,0.3580961054479551
63,46,2,1,14,17,0.07632969423639939,0.052205175144098385
63,47,2,1,18,21,0.6235793181150219,0.42649283275797645
63,48,2,3,27,32,0.31517250627031024,0.21556009171853513
63,49,2,2,35,39,0.5549866701837375,0.3795793578033951
63,50,2,1,16,19,0.10130362969936615,0.06928592842006083
63,51,2,1,9,12,2.0135176860962067,1.377131724553214
63,52,2,2,37,41,0.43200462960482267,0.2954666277285612
63,53,2,2,8,12,1.6468484676525459,1.1263508068474974
63,54,2,3,14,19,1.866683615195096,1.2767055605917448
63,55,2,2,14,18,2.657734696881587,1.8177395668262208
63,56,2,1,12,15,0.7022470274582615,0.4802970774301687
63,57,2,0,12,14,2.6482605611986147,1.8112597961731811
63,58,2,2,7,11,2.843121408001814,1.9445335468131684
63,59,0,0,1,1,0.08336218337170269,0.05701499825003719
63,60,2,2,13,17,0.9946594223137584,0.6802905457710496
63,61,2,1,15,18,0.07410433854676116,0.05068315825803993
63,62,2,2,14,18,0.1229022321916325,0.08405814567124466
63,64,2,1,25,28,0.6476138502067353,0.4429310874884142
63,65,2,1,24,27,0.7186226109935938,0.49149704639507996
63,66,2,1,23,26,1.018688961486823,0.6967253856287416
63,67,2,1,22,25,1.0921654258320084,0.7469791135976963
63,68,2,1,21,24,1.5139985092361843,1.035488981493754
63,69,2,1,20,23,1.7626467680243059,1.2055502666746776
63,70,2,2,12,16,1.9804932002727327,1.3545448521216445
63,71,2,2,11,15,2.1851663937483905,1.4945296905202674
63,72,2,2,10,14,2.4156112997311654,1.6521409163773608
63,73,2,1,19,22,0.6450110687135344,0.441150932791429
63,74,2,1,17,20,0.15106182424721992,0.10331770710346203
63,75,2,0,3,5,0.21476249049494597,0.14688534446303186
63,76,2,0,2,4,2.5850103249507614,1.768000227347997
63,77,1,0,1,2,0.02196026152894708,0.015019571489154284
63,78,2,1,11,14,8.6599765678721,5.922932064543238
64,0,2,0,0,2,0.0005423899561272664,0.0003709639209129824
64,1,1,0,6,7,0.5250492395414869,0.35910385576348647
64,2,1,1,5,7,3.0663398703694416,2.0972022957172
64,3,1,1,4,6,3.179384440800747,2.174518360683714
64,4,1,1,5,7,3.2421193721636867,2.217425490238197
64,5,1,0,9,10,0.16970050804866688,0.11606550810075722
64,6,1,0,8,9,0.1646347224516587,0.11260079850143394
64,7,1,1,7,9,0.1537077713439809,0.1051273846213703
64,8,1,0,3,4,1.9482403588540524,1.3324857406316615
64,9,1,0,2,3,3.952999574084982,2.7036271686156246
64,10,1,0,1,2,3.9484658493690423,2.700526358436591
64,11,1,0,1,2,0.06919444914119964,0.047325072798380635
64,12,1,0,2,3,0.0010819638042365637,0.000740001783903507
64,13,1,0,0,1,0.0009014109111883643,0.0006165138609051202
64,14,0,1,1,2,0.020126178646067514,0.013765162977664913
64,15,1,1,1,3,0.3155309425343453,0.21580524176307736
64,16,1,2,5,8,7.364333152280509,5.036785563998215
64,17,1,2,5,8,7.138083174421456,4.882043430695554
64,18,1,0,7,8,0.09875036195846627,0.06753963831714711
64,19,0,0,18,18,0.023052245306509973,0.015766426365653972
64,20,0,0,1,1,0.0008322652698986915,0.0005692221699047783
64,21,0,0,2,2,0.29442632736373614,0.2013708837802172
64,22,0,1,5,6,0.38083085428782437,0.26046667220752023
64,23,0,1,6,7,0.8388481433071447,0.5737244813928263
64,24,0,1,3,4,0.19732242088489188,0.13495732748842737
64,25,0,1,4,5,0.2418596995402701,0.16541829626218635
64,26,0,2,1,3,0.0620732343265041,0.04245456636757346
64,27,0,1,9,10,0.3955042491694762,0.270502440821799
64,28,0,1,8,9,0.2801676705316142,0.19161877243367978
64,29,0,0,16,16,0.3829030071881619,0.26188390708799075
64,30,0,1,2,3,1.2854928743986895,0.8792041069446808
64,31,0,1,26,27,1.0281926830822274,0.7032253913653327
64,32,1,1,3,5,1.204458402053683,0.8237811308172157
64,33,0,0,14,14,0.24709330634563198,0.16899778603536786
64,34,0,2,24,26,1.5762395915596081,1.0780583463570432
64,35,1,0,3,4,0.6531856318712005,0.446741869656062
64,36,0,0,17,17,0.702087612921475,0.4801880469421429
64,37,0,1,20,21,0.9800733158669842,0.6703144774880304
64,38,0,1,13,14,0.795303721633819,0.5439425703980826
64,39,0,1,11,12,0.34801298844074313,0.23802111610328266
64,40,0,1,27,28,1.497931236166881,1.024499879374817
64,41,1,0,4,5,1.6528815197237128,1.1304770717720403
64,42,1,1,6,8,1.454500843015212,0.9947959574117872
64,43,0,1,7,8,0.14176425764641046,0.09695869967306527
64,44,0,0,15,15,0.3964569425808526,0.27115402899986113
64,45,0,0,12,12,0.051527038599014106,0.035241567539720055
64,46,0,0,11,11,0.11926627538598013,0.08157135774743109
64,47,0,0,7,7,1.136205812709132,0.7771002366197992
64,48,0,2,2,4,0.09946314174212408,0.06802713920153142
64,49,0,1,10,11,0.9840565771025441,0.6730388019141582
64,50,0,0,9,9,0.568424821772718,0.3887702901703314
64,51,1,1,2,4,1.4209310816816165,0.9718361475042794
64,52,0,1,12,13,0.49016323811563023,0.3352438123985333
64,53,0,1,19,20,1.1742807398742574,0.8031413240516193
64,54,0,2,25,27,1.326894804453044,0.9075206753708198
64,55,0,1,25,26,2.0066830490897494,1.3724572210649204
64,56,0,0,13,13,0.16663214632641898,0.1139669229732013
64,57,1,0,5,6,2.7076018909728954,1.851845895005904
64,58,0,1,18,19,2.1555045300187103,1.474242660595681
64,59,1,2,7,10,0.23947729898949074,0.16378886961164016
64,60,0,1,24,25,0.7153108066938526,0.4892319603726532
64,61,0,0,10,10,0.3235166929612583,0.22126704144490086
64,62,0,1,11,12,0.14213542605150545,0.09721255777887565
64,63,1,2,8,11,0.3453940534435922,0.23622991332715426
64,65,0,0,1,1,0.15625,0.10686612461727264
64,66,0,0,2,2,0.3794642857142857,0.25953201692766215
64,67,0,0,3,3,0.53515625,0.3660164768141588
64,68,0,0,4,4,0.8794642857142857,0.6015036157029345
64,69,0,0,5,5,1.1294642857142858,0.7724894150905708
64,70,0,1,23,24,1.3482142857142858,0.9221019895547525
64,71,0,1,22,23,1.5535714285714286,1.0625546104803107
64,72,0,1,21,22,1.8270833333333334,1.2496212171913081
64,73,0,0,6,6,1.149108804016773,0.7859251497527142
64,74,0,0,8,8,0.6746390994752797,0.46141482288774294
64,75,1,0,4,5,0.158492325147023,0.10839974764827554
64,76,1,0,5,6,1.9647016605062253,1.343744335919493
64,77,1,1,8,10,0.5054200825813545,0.34567862738695204
64,78,1,1,4,6,5.908975702143291,4.0414037359723585
65,0,2,0,0,2,0.0005310689781752359,0.00036322101505307136
65,1,1,0,6,7,0.6398383085692986,0.43761305867821826
65,2,1,1,5,7,2.7896361465694612,1.907952666087298
65,3,1,1,4,6,2.877693671635081,1.9681790113490651
65,4,1,1,5,7,2.9132260711549645,1.9924811542933374
65,5,1,0,9,10,0.10764665625512919,0.07362419828475743
65,6,1,0,8,9,0.12704931690339713,0.08689451604952193
65,7,1,1,7,9,0.20035047345349472,0.13702834344454873
65,8,1,0,3,4,2.307143953709975,1.5779554129098066
65,9,1,0,2,3,4.504075871904973,3.080532053840946
65,10,1,0,1,2,4.439100010259079,3.0360922552632514
65,11,1,0,1,2,0.0734827878934418,0.05025805291676905
65,12,1,0,2,3,0.001063646462806675,0.0007274737628353241
65,13,1,0,0,1,0.0004335475932626235,0.0002965219272263818
65,14,0,1,2,3,0.03958780855475333,0.02707581236695681
65,15,1,1,1,3,0.3280702254713019,0.22438139902997042
65,16,1,2,5,8,6.700751408942465,4.582933344623428
65,17,1,2,5,8,6.415129328199133,4.387584065428794
65,18,1,0,7,8,0.1290964667666845,0.08829465027288386
65,19,0,0,17,17,0.020599439166315767,0.014088846291157935
65,20,0,0,2,2,0.0014402690798243824,0.000985062239788269
65,21,0,0,3,3,0.3299708165821917,0.22568129539158852
65,22,0,1,6,7,0.4612811816429371,0.3154901263427641
65,23,0,1,7,8,0.959555155963953,0.6562812215960979
65,24,0,1,4,5,0.2940915917702284,0.20114194364805954
65,25,0,1,5,6,0.31369363510019366,0.21454862784168027
65,26,0,2,2,4,0.1394920237553317,0.09540462076001813
65,27,0,1,10,11,0.4774425503543739,0.3265435845360575
65,28,0,1,9,10,0.36087398731721054,0.24681730879854774
65,29,0,0,15,15,0.30575921205464734,0.2091219331731906
65,30,0,1,3,4,1.4767762565784206,1.010031074990969
65,31,0,1,25,26,0.9360200739999018,0.6401845623829905
65,32,1,1,3,5,1.0765158583734458,0.7362756983898039
65,33,0,0,13,13,0.13520204080092393,0.09247051610074314
65,34,0,2,23,25,1.409719485492691,0.9641680525571802
65,35,1,0,3,4,0.6333043257681307,0.4331441855884473
65,36,0,0,16,16,0.5920782515564328,0.4049478925696425
65,37,0,1,19,20,0.851198885187005,0.5821716872862593
65,38,0,1,14,15,0.9076059697070383,0.6207509290373947
65,39,0,1,12,13,0.2584415842490055,0.17675936351129334
65,40,0,1,26,27,1.3093881858244676,0.8955471426476934
65,41,1,0,4,5,1.6049864961890632,1.0977195962289934
65,42,1,1,6,8,1.3064430920679522,0.893532865806776
65,43,0,1,8,9,0.2022929270625336,0.1383568713770084
65,44,0,0,14,14,0.2832502073181583,0.19372705250003594
65,45,0,0,11,11,0.1450294026059814,0.09919187335718024
65,46,0,0,10,10,0.1722078847078599,0.11778041131050926
65,47,0,0,6,6,1.28423622773014,0.8783446320040017
65,48,0,2,3,5,0.16474189895606406,0.11267410114255924
65,49,0,1,11,12,1.1253117481890273,0.7696493152975968
65,50,0,0,8,8,0.7194901018481656,0.4920903608640016
65,51,1,1,2,4,1.2773195132342139,0.8736139921751138
65,52,0,1,13,14,0.6321550442731593,0.4323581423278909
65,53,0,1,18,19,1.0397146114498752,0.7111057358950501
65,54,0,2,24,26,1.1755262410072362,0.8039931760790615
65,55,0,1,24,25,1.8255306032688345,1.248559238026062
65,56,0,0,12,12,0.053983341721608465,0.03692153935154063
65,57,1,0,5,6,2.7843972417742413,1.9043695527899922
65,58,0,1,17,18,1.9595354478734266,1.3402109399321904
65,59,1,2,7,10,0.32293481690271514,0.22086907127284272
65,60,0,1,23,24,0.636953925907781,0.4356403047777405
65,61,0,0,9,9,0.42566612530258,0.29113145082839753
65,62,0,1,10,11,0.21413867446313017,0.14645868973154846
65,63,1,2,8,11,0.4380175914627619,0.29957915208842967
65,64,0,0,1,1,0.17857142857142858,0.12213271384831159
65,66,0,0,1,1,0.20089285714285715,0.13739930307935055
65,67,0,0,2,2,0.37890625,0.25915035219688615
65,68,0,0,3,3,0.7008928571428571,0.47937090185462305
65,69,0,0,4,4,0.9508928571428571,0.6503567012422593
65,70,0,1,22,23,1.1696428571428572,0.7999692757064409
65,71,0,1,21,22,1.375,0.9404218966319993
65,72,0,1,20,21,1.6604166666666667,1.1356306842662172
65,73,0,0,5,5,1.296143603425443,0.8864886006114828
65,74,0,0,7,7,0.8530991857124618,0.5834713849039472
65,75,1,0,4,5,0.14244829215086321,0.09742654041927556
65,76,1,0,5,6,1.7866180748576799,1.2219452789197605
65,77,1,1,8,10,0.6416381066275156,0.43884401831710057
65,78,1,1,4,6,5.2692407532878205,3.6038613694673134
66,0,2,0,0,2,0.0005310689781752359,0.00036322101505307136
66,1,1,0,6,7,0.7697573207763289,0.5264702833097028
66,2,1,1,5,7,2.4786316727452276,1.6952432718074268
66,3,1,1,4,6,2.5386729874464105,1.7363081205692918
66,4,1,1,5,7,2.5437433874939708,1.7397759861906812
66,5,1,0,9,10,0.0734304913809399,0.05022228507278777
66,6,1,0,8,9,0.21006894955918318,0.14367522906759186
66,7,1,1,7,9,0.2536506639464551,0.17348264616035722
66,8,1,0,3,4,2.7124178777986354,1.855139756434862
66,9,1,0,2,3,5.125192897604375,3.5053408184508785
66,10,1,0,1,2,4.991816195385903,3.41411873025683
66,11,1,0,1,2,0.07856049839579998,0.05373091847398789
66,12,1,0,2,3,0.001060524212969074,0.0007253383212978435
66,13,1,0,0,1,0.00042402023816421605,0.0002900057575161775
66,14,0,1,3,4,0.06503708278504049,0.04448167035936009
66,15,1,1,1,3,0.34324157130906197,0.23475773781339318
66,16,1,2,5,8,5.95504571304406,4.07291300653902
66,17,1,2,5,8,5.603142565700987,3.8322312427170973
66,18,1,0,7,8,0.16369907031170042,0.11196086558503586
66,19,0,0,16,16,0.01784166119436292,0.012202682806886049
66,20,0,0,3,3,0.002399971327201431,0.0016414440635557721
66,21,0,0,4,4,0.3699974575891691,0.2530572442291084
66,22,0,1,7,8,0.5519127585882949,0.3774769768778204
66,23,0,1,8,9,1.0954838840951577,0.7492487505531327
66,24,0,1,5,6,0.40411313100292406,0.2763904269903021
66,25,0,1,6,7,0.39478208330638176,0.2700085203922323
66,26,0,2,3,5,0.23643702995893534,0.1617094982894682
66,27,0,1,11,12,0.5701067456090034,0.38992063053695686
66,28,0,1,10,11,0.4528075995632385,0.30969467752046803
66,29,0,0,14,14,0.21916267854570126,0.1498948231482891
66,30,0,1,4,5,1.6919982249334105,1.1572306762108027
66,31,0,1,24,25,0.8326100827415595,0.569458002303086
66,32,1,1,3,5,0.9416600363928581,0.6440419762960938
66,33,0,0,12,12,0.0371703195178791,0.02542238718503366
66,34,0,2,22,24,1.2224321158157527,0.8360741300795039
66,35,1,0,3,4,0.6125710931033872,0.4189638321441633
66,36,0,0,15,15,0.46842082846093536,0.3203732392168474
66,37,0,1,18,19,0.7062840425801292,0.48305816646117883
66,38,0,1,15,16,1.0346393958679991,0.7076345767217234
66,39,0,1,13,14,0.18760285244876632,0.1283096947734123
66,40,0,1,25,26,1.0992275669318923,0.7518092169631041
66,41,1,0,4,5,1.5559361444690765,1.0641719418326467
66,42,1,1,6,8,1.1399062002659097,0.779631091517558
66,43,0,1,9,10,0.2730628786247904,0.1867594983389955
66,44,0,0,13,13,0.15719939588871015,0.10751545747713841
66,45,0,0,10,10,0.30318640541640646,0.20736227957435288
66,46,0,0,9,9,0.2319818000524083,0.15866237410137526
66,47,0,0,5,5,1.450799174307077,0.9922642262792725
66,48,0,2,4,6,0.25679873609722337,0.1756357486932735
66,49,0,1,12,13,1.2846473747885139,0.8786258332377694
66,50,0,0,7,7,0.8896214572704485,0.608450544095126
66,51,1,1,2,4,1.1233939152803387,0.7683376265256608
66,52,0,1,14,15,0.8000624975587844,0.5471973028206301
66,53,0,1,17,18,0.8883690194895026,0.6075939477944928
66,54,0,2,23,25,1.0052894001268222,0.6875608467864078
66,55,0,1,23,24,1.621912196622776,1.1092958139044096
66,56,0,0,11,11,0.17759071354792608,0.12146196047925144
66,57,1,0,5,6,2.8789838485132213,1.969061419048506
66,58,0,1,16,17,1.7390996960460288,1.1894454069729017
66,59,1,2,7,10,0.41891131306251145,0.2865115429460714
66,60,0,1,22,23,0.5488278726824477,0.37536709014729663
66,61,0,0,8,8,0.5407719055021327,0.36985726619462983
66,62,0,1,9,10,0.2955664123885381,0.20215063717755977
66,63,1,2,8,11,0.543300779459639,0.3715868723353289
66,64,0,0,2,2,0.3794642857142857,0.25953201692766215
66,65,0,0,1,1,0.17578125,0.12022439019443172
66,67,0,0,1,1,0.203125,0.1389259620024544
66,68,0,0,2,2,0.5,0.34197159877527245
66,69,0,0,3,3,0.75,0.5129573981629088
66,70,0,1,21,22,0.96875,0.6625699726270904
66,71,0,1,20,21,1.1741071428571428,0.8030225935526487
66,72,0,1,19,20,1.4729166666666667,1.0073913347254901
66,73,0,0,4,4,1.4615635310288648,0.9996264348351469
66,74,0,0,6,6,1.0539118699359242,0.7208158542604501
66,75,1,0,4,5,0.12440300399487664,0.08508458833714913
66,76,1,0,5,6,1.5864051443082736,1.0850110070088343
66,77,1,1,8,10,0.7959875383857666,0.5444102622139483
66,78,1,1,4,6,4.603314420332525,3.1484055839727607
67,0,2,0,0,2,0.000547780071214546,0.0003746504534609418
67,1,1,0,6,7,0.9204734556996481,0.6295515585516172
67,2,1,1,5,7,2.1197966432283013,1.449820494326476
67,3,1,1,4,6,2.147660466065876,1.4688777664139885
67,4,1,1,5,7,2.1178401519860075,1.448482365450242
67,5,1,0,9,10,0.12487753060945928,0.08540913758724962
67,6,1,0,8,9,0.36005673757839124,0.24625835639898233
67,7,1,1,7,9,0.31577211622427437,0.2159701908677325
67,8,1,0,3,4,3.1819512959168277,2.1762739437794547
67,9,1,0,2,3,5.843959402401216,3.9969362800338604
67,10,1,0,1,2,5.6312064609967,3.851425353001371
67,11,1,0,1,2,0.08470097592083878,0.057930656306950185
67,12,1,0,2,3,0.0010800960169984031,0.0007387243235274955
67,13,1,0,0,1,0.0010421888902757996,0.0007127980020668843
67,14,0,1,4,5,0.09536124849968933,0.06522167722128963
67,15,1,1,1,3,0.36199687696077715,0.2475853015318651
67,16,1,2,5,8,5.094911677350256,3.484630183844544
67,17,1,2,5,8,4.6675422240428786,3.1923337534140677
67,18,1,0,7,8,0.2039796297433886,0.13951048020186943
67,19,0,0,15,15,0.014658273963852284,0.010025426765409032
67,20,0,0,4,4,0.0035817407328771604,0.002449707209641037
67,21,0,0,5,5,0.41628692304217096,0.28471660924394
67,22,0,1,8,9,0.6567381280851039,0.44917157527588525
67,23,0,1,9,10,1.2526748240768764,0.8567584246702052
67,24,0,1,6,7,0.5318136786053126,0.3637303478464353
67,25,0,1,7,8,0.48866389451886383,0.33421834654473387
67,26,0,2,4,6,0.35060617701065205,0.23979470978563772
67,27,0,1,12,13,0.677557526258021,0.4634108610333482
67,28,0,1,11,12,0.5597928684393502,0.3828665244064006
67,29,0,0,13,13,0.1198992302620499,0.08200426292927547
67,30,0,1,5,6,1.9407237660377465,1.327344818106192
67,31,0,1,23,24,0.7136541704751264,0.4880989153000396
67,32,1,1,3,5,0.8039086631815964,0.549827861635005
67,33,0,0,11,11,0.15175840090386414,0.10379412596934634
67,34,0,2,21,23,1.0061098073492993,0.6881219587254426
67,35,1,0,3,4,0.5909952232929324,0.4042071627560665
67,36,0,0,14,14,0.3258209071863166,0.2228429930898287
67,37,0,1,17,18,0.5389921029038514,0.3686399823145524
67,38,0,1,16,17,1.182048708734814,0.8084541735125813
67,39,0,1,14,15,0.19391296412133202,0.1326254527276479
67,40,0,1,24,25,0.8608595346336263,0.5887790227591965
67,41,1,0,4,5,1.5062544645586096,1.0301924948149992
67,42,1,1,6,8,0.9475204085159242,0.6480501379447797
67,43,0,1,10,11,0.3562363199448194,0.24364540774669874
67,44,0,0,12,12,0.03869822708605734,0.026467389172775156
67,45,0,0,9,9,0.4899516723635483,0.3350991134415622
67,46,0,0,8,8,0.3011658826774522,0.20598035679154889
67,47,0,0,4,4,1.6432981072861221,1.1239225620260287
67,48,0,2,5,7,0.36928867773854684,0.25257247907171443
67,49,0,1,13,14,1.4691426418291782,1.004810116110503
67,50,0,0,6,6,1.0863438911396086,0.7429975145455249
67,51,1,1,2,4,0.9605047862683685,0.6569307147829907
67,52,0,1,15,16,0.9993457860020226,0.6834957523368859
67,53,0,1,16,17,0.7135704145040374,0.488041630973359
67,54,0,2,22,24,0.8086855080426962,0.5530949521835086
67,55,0,1,22,23,1.3869596334404937,0.9486016065688228
67,56,0,0,10,10,0.3731363949426124,0.25520409907953334
67,57,1,0,5,6,2.998042694826076,2.0504909070923993
67,58,0,1,15,16,1.4844303610247354,1.0152660476603674
67,59,1,2,7,10,0.5310550513162174,0.36321148987258245
67,60,0,1,21,22,0.4470469984676198,0.30575475358731746
67,61,0,0,7,7,0.6739018144283404,0.46091056179523315
67,62,0,1,8,9,0.38986435445682005,0.26664507319817654
67,63,1,2,8,11,0.6657008309833193,0.4553015549547863
67,64,0,0,3,3,0.6116071428571429,0.4183045449304672
67,65,0,0,2,2,0.37890625,0.25915035219688615
67,66,0,0,1,1,0.23214285714285715,0.15877252800280506
67,68,0,0,1,1,0.26785714285714285,0.1831990707724674
67,69,0,0,2,2,0.5178571428571429,0.35418487016010364
67,70,0,1,20,21,0.7366071428571429,0.5037974446242853
67,71,0,1,19,20,0.9419642857142857,0.6442500655498437
67,72,0,1,18,19,1.25625,0.859203641922872
67,73,0,0,3,3,1.6527207452585446,1.1303671111702487
67,74,0,0,5,5,1.285993273302622,0.879546351371087
67,75,1,0,4,5,0.10355924650419025,0.07082864219000096
67,76,1,0,5,6,1.3552986176899338,0.9269472702186867
67,77,1,1,8,10,0.9751011442472753,0.6669137945316767
67,78,1,1,4,6,3.941152082648181,2.6955241574393867
68,0,2,0,0,2,0.0005872688250106898,0.0004016585179995626
68,1,1,0,6,7,1.0948340303362982,0.7488042874953579
68,2,1,1,5,7,1.7069495298721824,1.1674565195181799
68,3,1,1,4,6,1.6981741193886004,1.16145463721222
68,4,1,1,5,7,1.6289275066972733,1.1140938875085697
68,5,1,0,9,10,0.2247158431986087,0.15369287233752332
68,6,1,0,8,9,0.5469430254899158,0.37407796173154223
68,7,1,1,7,9,0.38781533571909765,0.2652436607708577
68,8,1,0,3,4,3.72472473884518,2.5475001478813906
68,9,1,0,2,3,6.674232541306311,4.564795945496938
68,10,1,0,1,2,6.369610683001765,4.356451897684337
68,11,1,0,1,2,0.0920762928483886,0.06297495414932727
68,12,1,0,2,3,0.0011318020430363292,0.0007740883083085063
68,13,1,0,0,1,0.0018308656380570261,0.001252208098778141
68,14,0,1,5,6,0.13071711821460522,0.08940308380628965
68,15,1,1,1,3,0.38502732371173976,0.263336818923736
68,16,1,2,5,8,4.105864707951298,2.808178237066145
68,17,1,2,5,8,3.594417158698166,2.4583771648505683
68,18,1,0,7,8,0.2506597216147513,0.17143701149832244
68,19,0,0,14,14,0.010993571327239871,0.0075189783260524255
68,20,0,0,5,5,0.004972866100753324,0.0034011579419399385
68,21,0,0,6,6,0.4697319646590478,0.3212699819006087
68,22,0,1,9,10,0.7777659713127255,0.5319477453656308
68,23,0,1,10,11,1.4341539389692994,0.9808798307983716
68,24,0,1,7,8,0.679485805752761,0.4647296946767518
68,25,0,1,8,9,0.597114750273973,0.4083925716069762
68,26,0,2,5,7,0.48315961118096695,0.3304537293983885
68,27,0,1,13,14,0.8018343769479802,0.5484091676757505
68,28,0,1,12,13,0.6837651074910318,0.4676564939909083
68,29,0,0,12,12,0.026130089141404828,0.01787149671965319
68,30,0,1,6,7,2.2277365008805177,1.5236452257122834
68,31,0,1,22,23,0.5775643348175925,0.3950211979462977
68,32,1,1,3,5,0.6837175217837441,0.46762394807010826
68,33,0,0,10,10,0.3207293983076318,0.21936069022698398
68,34,0,2,20,22,0.7567520142762166,0.5175753923968912
68,35,1,0,3,4,0.5696341897988129,0.3895974292051141
68,36,0,0,13,13,0.16270943560159454,0.11128401165699903
68,37,0,1,16,17,0.3465040207853228,0.23698906794003413
68,38,0,1,17,18,1.3526862010026115,0.9251605255962252
68,39,0,1,15,16,0.3036969991355703,0.20771149667528702
68,40,0,1,23,24,0.5990045964511304,0.40968511904425986
68,41,1,0,4,5,1.4592020487234207,0.9980113150762023
68,42,1,1,6,8,0.7256731419284606,0.4963192090671016
68,43,0,1,11,12,0.4530337419207575,0.30984934604757125
68,44,0,0,11,11,0.17104697518110687,0.11698641513671493
68,45,0,0,8,8,0.7065333518183513,0.48322867981874723
68,46,0,0,7,7,0.38106109163171664,0.26062414147269747
68,47,0,0,3,3,1.8654362861601328,1.2758524583831743
68,48,0,2,6,8,0.5017229971116488,0.3431500309291839
68,49,0,1,14,15,1.6823551579708194,1.1506353661582143
68,50,0,0,5,5,1.313423414724007,0.8983070100040926
68,51,1,1,2,4,0.8047169964928319,0.550380715704578
68,52,0,1,16,17,1.2328714450420204,0.8432140382908003
68,53,0,1,15,16,0.5121222082750856,0.35026250066430814
68,54,0,2,21,23,0.5821422560596117,0.3981522360386988
68,55,0,1,21,22,1.1166008779600511,0.7636915748597431
68,56,0,0,9,9,0.6024113281504786,0.41201513001590895
68,57,1,0,5,6,3.1469254837062794,2.152318277779368
68,58,0,1,14,15,1.190704840869463,0.8143744762031733
68,59,1,2,7,10,0.6612560331651826,0.4522615657225841
68,60,0,1,20,21,0.3297456874282772,0.22552731983819843
68,61,0,0,6,6,0.8275946388534909,0.566027723573145
68,62,0,1,7,8,0.49878612982498327,0.3411413805263603
68,63,1,2,8,11,0.8074658715926316,0.5522607901300022
68,64,0,0,4,4,0.8794642857142857,0.6015036157029345
68,65,0,0,3,3,0.61328125,0.41944953912279515
68,66,0,0,2,2,0.5,0.34197159877527245
68,67,0,0,1,1,0.234375,0.16029918692590894
68,69,0,0,1,1,0.25,0.17098579938763622
68,70,0,1,19,20,0.46875,0.32059837385181794
68,71,0,1,18,19,0.6741071428571429,0.46105099477737627
68,72,0,1,17,18,1.00625,0.6882178425352358
68,73,0,0,2,2,1.873291645326898,1.2812250778496
68,74,0,0,4,4,1.5538023227435545,1.0627125289786905
68,75,1,0,4,5,0.07952922286692996,0.054393470986317985
68,76,1,0,5,6,1.0891850802460583,0.7449407265078359
68,77,1,1,8,10,1.1823158852960816,0.8086369071042053
68,78,1,1,4,6,3.4041214814341454,2.328225730862567
69,0,2,0,0,2,0.0006402631116564719,0.000437903599859989
69,1,1,0,6,7,1.2578410750854097,0.8602918469043301
69,2,1,1,5,7,1.3237867144793751,0.9053949183759541
69,3,1,1,4,6,1.281876610531645,0.8767307878722678
69,4,1,1,5,7,1.177867174689192,0.8055942417467521
69,5,1,0,9,10,0.3247044778854142,0.2220794188639304
69,6,1,0,8,9,0.725140732294534,0.49595507111966725
69,7,1,1,7,9,0.45525197616245044,0.3113664922677508
69,8,1,0,3,4,4.2319353562529916,2.8944033993828753
69,9,1,0,2,3,7.449770715876819,5.095220004435204
69,10,1,0,1,2,7.059229679658555,4.828112119349381
69,11,1,0,1,2,0.09918197793643156,0.06783483912923059
69,12,1,0,2,3,0.0012048012308067159,0.0008240156062107772
69,13,1,0,0,1,0.002578052640155157,0.0017632415661613422
69,14,0,1,6,7,0.16385624722980763,0.11206836566898724
69,15,1,1,1,3,0.40765311404965476,0.27881157431455783
69,16,1,2,5,8,3.188923973868162,2.1810428594329805
69,17,1,2,5,8,2.6061909763021354,1.7824865897594586
69,18,1,0,7,8,0.29433665048988905,0.20130954989237188
69,19,0,0,13,13,0.007592366940689023,0.005192747722391898
69,20,0,0,6,6,0.006281380955326122,0.004296107775618844
69,21,0,0,7,7,0.5196374876993085,0.355402524904197
69,22,0,1,10,11,0.8907705061822692,0.6092364282820185
69,23,0,1,11,12,1.6036037526174078,1.096773878169203
69,24,0,1,8,9,0.8174685554817025,0.5591020577331807
69,25,0,1,9,10,0.6984042219638128,0.4776688167527306
69,26,0,2,6,8,0.6071843538054754,0.4152796084443782
69,27,0,1,14,15,0.9180032868798575,0.62786210339052
69,28,0,1,13,14,0.7997612490959758,0.5469912659837195
69,29,0,0,11,11,0.11048026749319016,0.07556222741553201
69,30,0,1,7,8,2.495629292177663,1.706868677992794
69,31,0,1,21,22,0.4526257951824178,0.30957033365092085
69,32,1,1,3,5,0.6292454639775943,0.430368154677012
69,33,0,0,9,9,0.48001062913401477,0.32830000454816677
69,34,0,2,19,21,0.5245699296672571,0.35877603503548827
69,35,1,0,3,4,0.553481836862362,0.3785501372897929
69,36,0,0,12,12,0.03741894685180751,0.02559243415879912
69,37,0,1,15,16,0.16904733988367926,0.11561877817745733
69,38,0,1,18,19,1.5123114405163571,1.034335122319028
69,39,0,1,16,17,0.43970783299261534,0.30073518128499027
69,40,0,1,22,23,0.391944963775587,0.2680680917885075
69,41,1,0,4,5,1.4261307122066478,0.9753923994316506
69,42,1,1,6,8,0.5189052790389981,0.3549017357717901
69,43,0,1,12,13,0.5437795815276102,0.371914345752691
69,44,0,0,10,10,0.32847038386737126,0.22465508464290485
69,45,0,0,7,7,0.9090250454697744,0.6217214962521268
69,46,0,0,6,6,0.4556631309299546,0.31164769877412574
69,47,0,0,2,2,2.0727815086114845,1.4176648128233806
69,48,0,2,7,9,0.6263701400851002,0.42840159645998616
69,49,0,1,15,16,1.8815735110675376,1.2868894035859373
69,50,0,0,4,4,1.5254162241156426,1.0432980499171312
69,51,1,1,2,4,0.7097045551182236,0.48539760274374477
69,52,0,1,17,18,1.452733974270582,0.9935875195529329
69,53,0,1,14,15,0.3247456856401872,0.2221076026274937
69,54,0,2,20,22,0.3715067244706419,0.25408949704598005
69,55,0,1,20,21,0.8656077977375968,0.5920265650093373
69,56,0,0,8,8,0.8171606202515762,0.5588914475272496
69,57,1,0,5,6,3.2955976696192755,2.2540016079995318
69,58,0,1,13,14,0.9167878969851418,0.6270308457396575
69,59,1,2,7,10,0.7831926063646187,0.5356592554949625
69,60,0,1,19,20,0.22059694971893412,0.15087578316066458
69,61,0,0,5,5,0.9710850868440218,0.664167039389749
69,62,0,1,6,7,0.6005018562326373,0.41070915968678756
69,63,1,2,8,11,0.9400782762796298,0.6429601422264947
69,64,0,0,5,5,1.1294642857142858,0.7724894150905708
69,65,0,0,4,4,0.83203125,0.5690621135869769
69,66,0,0,3,3,0.75,0.5129573981629088
69,67,0,0,2,2,0.453125,0.30991176139009063
69,68,0,0,1,1,0.25,0.17098579938763622
69,70,0,1,18,19,0.21875,0.14961257446418172
69,71,0,1,17,18,0.42410714285714285,0.29006519538974
69,72,0,1,16,17,0.7729166666666667,0.5286310964401086
69,73,0,0,1,1,2.0791611372903107,1.4220281164611628
69,74,0,0,3,3,1.8037703214237062,1.2336764412813037
69,75,1,0,4,5,0.05714428280002714,0.03908344349998316
69,76,1,0,5,6,0.8418108858894857,0.5757508290281118
69,77,1,1,8,10,1.3760211205604351,0.9411202850931878
69,78,1,1,4,6,3.2255050956208713,2.206062268814515
70,0,3,0,0,3,0.0006965969133895024,0.00047643272034745627
70,1,2,0,6,8,1.4006130275878492,0.9579397526193831
70,2,2,1,5,8,0.992181044622725,0.6785954762083065
70,3,2,1,4,7,0.9235668792960252,0.6316672845775015
70,4,2,1,5,8,0.7943563310876426,0.5432946090786015
70,5,2,0,9,11,0.4137769633818787,0.2829999394081569
70,6,2,0,8,10,0.8822764454867602,0.6034269732497438
70,7,2,1,7,10,0.5143544636077746,0.3517892365142967
70,8,2,0,3,5,4.676079890302973,3.198173032175617
70,9,2,0,2,4,8.128717691722871,5.559581170062625
70,10,2,0,1,3,7.662903392393666,5.240990648714642
70,11,2,0,1,3,0.1055404952107825,0.07218370376553056
70,12,2,0,2,4,0.001285047437661055,0.0008788994535180364
70,13,2,0,0,2,0.0032346560503474925,0.0022123210020508805
70,14,1,1,19,21,0.1929078875773854,0.131938037462398
70,15,2,1,1,4,0.4282071592778345,0.2928693737305176
70,16,2,2,5,9,2.3970033375028916,1.6394141271910556
70,17,2,2,5,9,1.7695776215463639,1.210290576794308
70,18,2,0,7,9,0.33260682072589426,0.22748417249438896
70,19,1,0,0,1,0.0046642784794743404,0.003190101537517874
70,20,1,0,19,20,0.007430194656602932,0.0050818310918599825
70,21,1,0,20,21,0.5633185653983445,0.38527790085812946
70,22,1,1,23,25,0.9896732375025985,0.676880278587727
70,23,1,1,24,26,1.751911588772685,1.1982080138510454
70,24,1,1,21,23,0.9382732293683145,0.6417255926702409
70,25,1,1,22,24,0.7870662773437425,0.5383086264106832
70,26,1,2,19,22,0.7158255184327437,0.4895839939651673
70,27,1,1,27,29,1.0197443170825822,0.697447188909458
70,28,1,1,26,28,0.9013998565502931,0.6165063001606099
70,29,1,0,2,3,0.20380735267989314,0.13939265247619773
70,30,1,1,20,22,2.730043501438288,1.8671946818257883
70,31,0,0,3,3,0.34670476436121705,0.237126365143219
70,32,2,1,3,6,0.6394508606220471,0.4373480662902907
70,33,1,0,4,5,0.6196855687214546,0.4238297293472795
70,34,0,1,1,2,0.3227755067810719,0.2207601121988439
70,35,2,0,3,5,0.5426119317944457,0.3711157396605714
70,36,1,0,1,2,0.13603628237053872,0.09304108994739506
70,37,0,0,3,3,0.04541976722686685,0.031064540829144754
70,38,1,1,31,33,1.652189526618186,1.1300037877947633
70,39,1,1,29,31,0.5670222876495756,0.38781103649747556
70,40,0,0,4,4,0.30684886021575236,0.20986719062070186
70,41,2,0,4,6,1.4063866912685248,0.961888610618726
70,42,2,1,6,9,0.3386256820409859,0.23160073174784604
70,43,1,1,25,27,0.6233638715388222,0.4263454795377492
70,44,1,0,3,4,0.4673971303232791,0.3196730878392523
70,45,1,0,6,7,1.0863298314165448,0.742987898493576
70,46,1,0,7,8,0.520955105764616,0.35630370081693374
70,47,1,0,11,12,2.2542179637865294,1.541757042128037
70,48,1,2,20,23,0.7358499673838569,0.5032795796099793
70,49,1,1,28,30,2.0560140752317384,1.4061968408229217
70,50,1,0,9,10,1.710936042266173,1.1701830675520006
70,51,2,1,2,5,0.6834476530389466,0.4674393731778725
70,52,1,1,30,32,1.64602916134557,1.1257904478721308
70,53,0,0,4,4,0.16303042819766642,0.1115035523595465
70,54,0,1,2,3,0.18993294512944922,0.12990334581202767
70,55,0,0,2,2,0.6482653267638934,0.443376660448046
70,56,1,0,5,6,1.0052892662690376,0.6875607552352867
70,57,2,0,5,7,3.432401491667314,2.347567651488203
70,58,0,0,5,5,0.6775043607129645,0.4633744988204628
70,59,2,2,7,11,0.8900834660216268,0.6087665318377032
70,60,0,0,1,1,0.12602902090374943,0.08619669154107484
70,61,1,0,8,9,1.0966605516516863,0.7500535243241989
70,62,1,1,7,9,0.6895279257075658,0.4715979343088271
70,63,2,2,8,12,1.0562630401454574,0.7224239211315437
70,64,1,0,18,19,1.3482142857142858,0.9221019895547525
70,65,1,0,17,18,1.0234375,0.6999731162431359
70,66,1,0,16,17,0.96875,0.6625699726270904
70,67,1,0,15,16,0.64453125,0.44082276404624965
70,68,1,0,14,15,0.46875,0.32059837385181794
70,69,1,0,13,14,0.21875,0.14961257446418172
70,71,0,0,1,1,0.20535714285714285,0.14045262092555832
70,72,0,0,2,2,0.56875,0.3889926936068724
70,73,1,0,12,13,2.2592988654753188,1.5452320902755077
70,74,1,0,10,11,2.0224988096285688,1.3832743028995342
70,75,2,0,4,6,0.03765140838157836,0.02575142464077809
70,76,2,0,5,7,0.6270692785506565,0.42887976745764933
70,77,2,1,8,11,1.5456654845481463,1.0571473938453717
70,78,2,1,4,7,3.3683569477550073,2.3037648213391537
71,0,3,0,0,3,0.0007560201701580185,0.0005170748525905823
71,1,2,0,6,8,1.534729142191747,1.0496675568846285
71,2,2,1,5,8,0.6886214198502274,0.47097793579416075
71,3,2,1,4,7,0.601605309631386,0.41146385913267575
71,4,2,1,5,8,0.46842082846093525,0.3203732392168473
71,5,2,0,9,11,0.49800044897853235,0.34060401945598445
71,6,2,0,8,10,1.0303378447772193,0.7046925601142684
71,7,2,1,7,10,0.5698935830937416,0.38977483948467073
71,8,2,0,3,5,5.093240131912329,3.483486941712877
71,9,2,0,2,4,8.76632350845771,5.995667331137078
71,10,2,0,1,3,8.229786495673213,5.628706491009031
71,11,2,0,1,3,0.11160850472091721,0.07633387759265921
71,12,2,0,2,4,0.0013718062614023498,0.0009382375608433817
71,13,2,0,0,2,0.0038521947110813155,0.0026346823682842522
71,14,1,1,19,21,0.22020853244316166,0.1506101278070889
71,15,2,1,1,4,0.4480546587446674,0.306443935979246
71,16,2,2,5,9,1.6753316421267495,1.1458316802737742
71,17,2,2,5,9,1.0673981651545061,0.7300397141353575
71,18,2,0,7,9,0.36856445018584194,0.2520771485635633
71,19,1,0,0,1,0.002136005320524571,0.0014609063089045516
71,20,1,0,19,20,0.008510589492926528,0.00582075979083224
71,21,1,0,20,21,0.6043343656538193,0.4133303784349533
71,22,1,1,23,25,1.0825352008010503,0.7403925866968915
71,23,1,1,24,26,1.8911646340534665,1.2934491869090339
71,24,1,1,21,23,1.0517199824600976,0.7193167277315623
71,25,1,1,22,24,0.8703197209756749,0.5952492528554011
71,26,1,2,19,22,0.8178751451697378,0.5593801419845066
71,27,1,1,27,29,1.1153132345270145,0.762810899892847
71,28,1,1,26,28,0.9968984018500137,0.6818218805943264
71,29,1,0,2,3,0.2922713126420354,0.19989697612068866
71,30,1,1,20,22,2.950110962265998,2.0177083246611214
71,31,0,0,4,4,0.2539027637062314,0.17365506807616035
71,32,2,1,3,6,0.696565001201181,0.4764108942233349
71,33,1,0,4,5,0.7509191646487222,0.5135860545718312
71,34,0,1,2,3,0.1397542485937369,0.09558396765447413
71,35,2,0,3,5,0.5353553041030519,0.3661526185138857
71,36,1,0,1,2,0.26024675432719563,0.17799399730669327
71,37,0,0,2,2,0.1504848217651393,0.1029230701808732
71,38,1,1,31,33,1.7836363374738828,1.2199059399192302
71,39,1,1,29,31,0.689606760819455,0.4716518530473319
71,40,0,0,5,5,0.37459087969253196,0.25619888403018176
71,41,2,0,4,6,1.3960079891957962,0.9547901679366795
71,42,2,1,6,9,0.17170371968171722,0.11743559107043608
71,43,1,1,25,27,0.6981757695189091,0.47751256825707505
71,44,1,0,3,4,0.5981040273472479,0.4090691809317352
71,45,1,0,6,7,1.252838878806324,0.8568706287864368
71,46,1,0,7,8,0.5822580565732383,0.3982314370122666
71,47,1,0,11,12,2.424552197987945,1.658255982920077
71,48,1,2,20,23,0.8388369817440101,0.5737168475176464
71,49,1,1,28,30,2.219854747960059,1.5182545544175619
71,50,1,0,9,10,1.8851129555393578,1.2893101825555464
71,51,2,1,2,5,0.7131819348681108,0.48777593296898014
71,52,1,1,30,32,1.8280142231394152,1.2502578929418469
71,53,0,0,3,3,0.04548571072763063,0.031109642437914815
71,54,0,1,3,4,0.05544424684963805,0.03792071547612317
71,55,0,0,3,3,0.449057783099217,0.3071300160578375
71,56,1,0,5,6,1.1819963555846458,0.8084183669316536
71,57,2,0,5,7,3.5658609058683153,2.4388463099800584
71,58,0,0,4,4,0.4537492261657966,0.3103386966299203
71,59,2,2,7,11,0.9905413123200577,0.6774739924540932
71,60,0,0,2,2,0.04372373160976031,0.029904548806021294
71,61,1,0,8,9,1.2145600632622218,0.8306900932847561
71,62,1,1,7,9,0.7731170140123498,0.528768122644336
71,63,2,2,8,12,1.1654220766658083,0.7970825016108092
71,64,1,0,18,19,1.5535714285714286,1.0625546104803107
71,65,1,0,17,18,1.203125,0.8228691595529993
71,66,1,0,16,17,1.1741071428571428,0.8030225935526487
71,67,1,0,15,16,0.82421875,0.5637188073561131
71,68,1,0,14,15,0.6741071428571429,0.46105099477737627
71,69,1,0,13,14,0.42410714285714285,0.29006519538974
71,70,0,0,1,1,0.20535714285714285,0.14045262092555832
71,72,0,0,1,1,0.3770833333333333,0.25790358074301795
71,73,1,0,12,13,2.428409012939603,1.6608938252704748
71,74,1,0,10,11,2.227839601966855,1.523715740998944
71,75,2,0,4,6,0.019676958543801637,0.013457921944517207
71,76,2,0,5,7,0.42917554148409165,0.2935316921531162
71,77,2,1,8,11,1.7050131466492902,1.1661321433850318
71,78,2,1,4,7,3.7296416497878684,2.550863035673604
72,0,3,0,0,3,0.0008863094169212187,0.0006061852966282574
72,1,2,0,6,8,1.798756643024718,1.2302473700456098
72,2,2,1,5,8,0.2571555064067434,0.1758797593195577
72,3,2,1,4,7,0.3237694794902743,0.22143993307185372
72,4,2,1,5,8,0.5034034835763708,0.3442993882153062
72,5,2,0,9,11,0.6645355456023059,0.4545045659452371
72,6,2,0,8,10,1.3224791605310051,0.9045006257475361
72,7,2,1,7,10,0.6792652542145108,0.46457884995245624
72,8,2,0,3,5,5.914378752925606,4.0450991158009435
72,9,2,0,2,4,10.021220732482435,6.8539457511338515
72,10,2,0,1,3,9.3454282628592,6.3917420885791545
72,11,2,0,1,3,0.12377051945694752,0.08465200483987662
72,12,2,0,2,4,0.0015673938283202293,0.0010720083467623273
72,13,2,0,0,2,0.005068767310827393,0.003466748922206964
72,14,1,1,19,21,0.27396637588101697,0.18737743914139723
72,15,2,1,1,4,0.48840535197389484,0.33404151812982497
72,16,2,2,5,9,0.6754628043053148,0.46197819020303493
72,17,2,2,5,9,1.141877531752272,0.7809793702777728
72,18,2,0,7,9,0.43936499562988857,0.3005007000028872
72,19,1,0,0,1,0.004168349310198923,0.0028509141557250595
72,20,1,0,19,20,0.010639347657821853,0.007276709456942579
72,21,1,0,20,21,0.6850479521518542,0.4685338868701918
72,22,1,1,23,25,1.2652598796309695,0.8653658878072228
72,23,1,1,24,26,2.1651827934208283,1.480862043013662
72,24,1,1,21,23,1.2749835255397637,0.872016309281933
72,25,1,1,22,24,1.0341493877357224,0.7072994389929081
72,26,1,2,19,22,1.0187477183190385,0.696765571964445
72,27,1,1,27,29,1.3034480348344881,0.8914844167856738
72,28,1,1,26,28,1.184939216238772,0.8104311164573823
72,29,1,0,2,3,0.46688165547789773,0.31932053232524527
72,30,1,1,20,22,3.3830804935153123,2.313834890305738
72,31,0,0,5,5,0.14809204721637473,0.1012865483049736
72,32,2,1,3,6,0.9036969263214123,0.6180773654048658
72,33,1,0,4,5,1.0092551304637232,0.6902731810736511
72,34,0,1,3,4,0.2597157233292671,0.17763080226797162
72,35,2,0,3,5,0.529831096741383,0.36237437446701354
72,36,1,0,1,2,0.5082495313118036,0.34761380959896077
72,37,0,0,1,1,0.4378193052123779,0.29944353555631165
72,38,1,1,31,33,2.0425213778740563,1.3969686022485266
72,39,1,1,29,31,0.9348470694235911,0.639382293882327
72,40,0,0,6,6,0.7207180626939033,0.49293021633130224
72,41,2,0,4,6,1.3992174787708325,0.9569852764991348
72,42,2,1,6,9,0.1770432355958092,0.12108751665809217
72,43,1,1,25,27,0.8455420561417063,0.578302737541021
72,44,1,0,3,4,0.8555658016582943,0.5851584101010691
72,45,1,0,6,7,1.580524321500578,1.0809888582535108
72,46,1,0,7,8,0.7028804228948825,0.4807302839304051
72,47,1,0,11,12,2.7596793118002045,1.8874638927267189
72,48,1,2,20,23,1.0418097052997015,0.7125386610818688
72,49,1,1,28,30,2.5423611324025197,1.7388306022236035
72,50,1,0,9,10,2.2278170072961925,1.5237002875276435
72,51,2,1,2,5,0.8971042341581297,0.6135683384462439
72,52,1,1,30,32,2.187034521904032,1.4958073840644712
72,53,0,0,2,2,0.3064204305478285,0.20957416906369652
72,54,0,1,4,5,0.3396969190117012,0.23233339698693137
72,55,0,0,4,4,0.16377834749269518,0.1120150866736982
72,56,1,0,5,6,1.5297940941231931,1.046292264328556
72,57,2,0,5,7,3.8406416130641508,2.626780705484778
72,58,0,0,3,3,0.06880229827263824,0.04705686387941453
72,59,2,2,7,11,1.1883886050157333,0.812790302447092
72,60,0,0,3,3,0.14804895436088367,0.10125707523959747
72,61,1,0,8,9,1.4465379558990747,0.9893497949358423
72,62,1,1,7,9,0.9375940724151891,0.6412610878920817
72,63,2,2,8,12,1.3803493141320944,0.9440805236442062
72,64,1,0,18,19,1.9575892857142858,1.338879875562116
72,65,1,0,17,18,1.556640625,1.0646537664995788
72,66,1,0,16,17,1.578125,1.0793478586344538
72,67,1,0,15,16,1.177734375,0.8055034143026926
72,68,1,0,14,15,1.078125,0.7373762598591813
72,69,1,0,13,14,0.828125,0.5663904604715451
72,70,0,0,2,2,0.609375,0.4167778860073633
72,71,0,0,1,1,0.40401785714285715,0.276325265081805
72,73,1,0,12,13,2.761117528162331,1.8884475510242011
72,74,1,0,10,11,2.631832739108891,1.8000240990043441
72,75,2,0,4,6,0.01872753703219317,0.012808571560044437
72,76,2,0,5,7,0.1384108571243526,0.09466516419734135
72,77,2,1,8,11,2.0186851710054605,1.3806659907053433
72,78,2,1,4,7,4.868760116013297,3.3299553618526962
73,0,2,0,0,2,0.0008916268245728301,0.0006098221014201802
73,1,1,0,6,7,0.41136724321344437,0.28135182769095585
73,2,1,1,5,7,5.230126857763822,3.577109686693973
73,3,1,1,4,6,5.53923365675544,3.7885211791809126
73,4,1,1,5,7,5.815746872617498,3.9776405122025933
73,5,1,0,9,10,0.7354694328621887,0.5030193156124512
73,6,1,0,8,9,1.1267052442278556,0.7706023874341671
73,7,1,1,7,9,0.2362431705447111,0.16157690946182843
73,8,1,0,3,4,0.9661416832256622,0.660786032112225
73,9,1,0,2,3,0.6190301305018486,0.4233814468355655
73,10,1,0,1,2,0.4059551369742563,0.2776502544442423
73,11,1,0,1,2,0.05006320188848207,0.034240386379226904
73,12,1,0,2,3,0.001612524174291599,0.0011028749398925481
73,13,1,0,0,1,0.005074244816070564,0.0034704952246575782
73,14,0,1,7,8,0.17458699645467804,0.11940758860595815
73,15,1,1,1,3,0.26466483821408665,0.18101571572734007
73,16,1,2,5,8,12.554840810531122,8.586797968692728
73,17,1,2,5,8,12.79720075279895,8.752558402565555
73,18,1,0,7,8,0.1524764180278196,0.10428520889700049
73,19,0,0,12,12,0.04224828897580248,0.028895429853149784
73,20,0,0,7,7,0.007177370312163816,0.004908913601305673
73,21,0,0,8,8,0.038301906390717226,0.02619632832914879
73,22,0,1,11,12,0.2577262384751921,0.17627010763539713
73,23,0,1,12,13,0.15023703340897623,0.10275359702024327
73,24,0,1,9,10,0.5836529923031989,0.39918549381579344
73,25,0,1,10,11,0.3303676852325523,0.22595273100532373
73,26,0,2,7,9,0.6536696035592322,0.4470728787998983
73,27,0,1,15,16,0.2790286505848857,0.19083974748924043
73,28,0,1,14,15,0.3931280913144665,0.26887728382055887
73,29,0,0,10,10,0.9865670098212361,0.6747557952950161
73,30,0,1,8,9,0.22320715190044588,0.1526610131869411
73,31,0,1,20,21,1.7534208740481274,1.1992402792483474
73,32,1,1,3,5,2.31885057977714,1.5859620801747119
73,33,0,0,8,8,1.1373187229405046,0.7778614040020309
73,34,0,2,18,20,2.878413583372696,1.9686713900848436
73,35,1,0,3,4,0.8466634676145205,0.5790697192895073
73,36,0,0,11,11,1.5621201129616031,1.0684014250169773
73,37,0,1,14,15,1.987264341489389,1.3591759280964304
73,38,0,1,19,20,0.23362616809399822,0.15978702843769022
73,39,0,1,17,18,1.1839021194317805,0.809721801151039
73,40,0,1,21,22,2.9947258905393936,2.048222401362916
73,41,1,0,4,5,2.140141440706931,1.4637351801675282
73,42,1,1,6,8,2.6112398182095453,1.7859397108375397
73,43,0,1,13,14,0.3909635984969084,0.267396893681843
73,44,0,0,9,9,1.2850779404791852,0.8789203157130028
73,45,0,0,6,6,1.1416723584273465,0.780839043377871
73,46,0,0,5,5,0.29881246441353293,0.2043707523789501
73,47,0,0,1,1,0.03414646095293662,0.023354239689186294
73,48,0,2,8,10,0.660628241082804,0.4518321915983652
73,49,0,1,16,17,0.22980276592001628,0.15717203852929532
73,50,0,0,3,3,0.6179933239065136,0.42267233001751053
73,51,1,1,2,4,2.644544469542702,1.808718200563645
73,52,0,1,18,19,0.8778519237320153,0.6004008516931716
73,53,0,1,13,14,2.2257324841702064,1.5222745921154888
73,54,0,2,19,21,2.5106708103243065,1.7171562220100236
73,55,0,1,19,20,3.4257780982591965,2.3430376266220194
73,56,0,0,7,7,1.3599635067327984,0.9301377893468822
73,57,1,0,5,6,2.4320296050829646,1.6633701046380318
73,58,0,1,12,13,3.6864830979783596,2.5213450377473583
73,59,1,2,7,10,0.4672609595551585,0.31957995476869094
73,60,0,1,18,19,1.3280894574817625,0.908337750183245
73,61,0,0,4,4,0.4798230004580577,0.3281716771915806
73,62,0,1,5,6,0.42839890270017117,0.29300051533989985
73,63,1,2,8,11,0.41772145402400324,0.2856977469506397
73,64,0,0,6,6,1.39534640487751,0.9543376818425815
73,65,0,0,5,5,1.377152578639533,0.9418941381497005
73,66,0,0,4,4,1.774755716249336,1.2138320994426783
73,67,0,0,3,3,1.7560157918372037,1.2010150556183892
73,68,0,0,2,2,2.274711283611233,1.5557733088173715
73,69,0,0,1,1,2.5246956667096634,1.7267484271314117
73,70,0,1,17,18,2.743434336648601,1.8763532524774023
73,71,0,1,16,17,2.948782372855232,2.016799644971291
73,72,0,1,15,16,3.1292665319173083,2.1402405578274277
73,74,0,0,2,2,0.7209821428571429,0.4931108321625581
73,75,1,0,4,5,0.283847379825251,0.19413548457402618
73,76,1,0,5,6,3.3567666071929723,2.295837686754455
73,77,1,1,8,10,0.5988576807538162,0.40958463705246845
73,78,1,1,4,6,11.571871429522181,7.914502747151196
74,0,2,0,0,2,0.000674749964284223,0.0004614906481196675
74,1,1,0,6,7,0.11784206158705635,0.08059727640779955
74,2,1,1,5,7,4.109808821512591,2.8108757867067586
74,3,1,1,4,6,4.317206495383709,2.9527240149387155
74,4,1,1,5,7,4.482772158648113,3.0659615240763487
74,5,1,0,9,10,0.43764538886144955,0.29932458665115147
74,6,1,0,8,9,0.606650001361964,0.41491414172554414
74,7,1,1,7,9,0.05491457595187536,0.03755845066865789
74,8,1,0,3,4,0.6160558362587192,0.4213471985204633
74,9,1,0,2,3,1.8746012950577249,1.282120803874173
74,10,1,0,1,2,2.0943490206873827,1.4324157659957808
74,11,1,0,1,2,0.05654415276394461,0.03867298864415876
74,12,1,0,2,3,0.0012816366194037113,0.0008765666475728449
74,13,1,0,0,1,0.00290901230626381,0.0019895991784599555
74,14,0,1,9,10,0.07976246001938926,0.05455299195015859
74,15,1,1,1,3,0.28129533716881056,0.19239003235929492
74,16,1,2,5,8,9.866768721319053,6.748309348750654
74,17,1,2,5,8,9.865416680555958,6.747384629667924
74,18,1,0,7,8,0.03383020678617992,0.02313793980313604
74,19,0,0,10,10,0.03233623766128566,0.022116149782814072
74,20,0,0,9,9,0.0034335465155971513,0.0023483507828160476
74,21,0,0,10,10,0.1620209776352357,0.11081314551410842
74,22,0,1,13,14,0.08995004792280074,0.061520723396145095
74,23,0,1,14,15,0.39030079521287386,0.26694357388441337
74,24,0,1,11,12,0.1920933700724436,0.1313809537556072
74,25,0,1,12,13,0.0583378340148718,0.03989976473430436
74,26,0,2,9,11,0.2978793359154543,0.2037325454902487
74,27,0,1,17,18,0.11713077330725498,0.08011079562733198
74,28,0,1,16,17,0.10248644896874036,0.07009490961328103
74,29,0,0,8,8,0.674237318512141,0.4611400275310989
74,30,0,1,10,11,0.5670714408268119,0.3878446544786843
74,31,0,1,18,19,1.3790129804603721,0.9431665473197741
74,32,1,1,3,5,1.7335227765888133,1.1856311108468518
74,33,0,0,6,6,0.6760102040046195,0.46235258050371564
74,34,0,2,16,18,2.2059027504503557,1.508712180628558
74,35,1,0,3,4,0.7422951158999703,0.5076876950947781
74,36,0,0,9,9,1.1172709445882791,0.7641498623720252
74,37,0,1,12,13,1.46635613415528,1.002904303142018
74,38,0,1,21,22,0.39403719260466635,0.2694990574638754
74,39,0,1,19,20,0.7448964734597954,0.5094668759022171
74,40,0,1,19,20,2.22117440114913,1.5191571222393527
74,41,1,0,4,5,1.8746984782707665,1.2821872716716487
74,42,1,1,6,8,2.0131299123245245,1.3768665093198833
74,43,0,1,15,16,0.1408194355119924,0.09631249500133485
74,44,0,0,7,7,0.8250630597256942,0.5642962672496274
74,45,0,0,4,4,0.5569142307460615,0.38089769973786325
74,46,0,0,3,3,0.08385437111776319,0.05735162671087301
74,47,0,0,1,1,0.5765091723370511,0.3942995267454208
74,48,0,2,10,12,0.3059106645952237,0.20922551810806958
74,49,0,1,18,19,0.46758443524312554,0.319801193765049
74,50,0,0,1,1,0.0271170853471143,0.01854654606055638
74,51,1,1,2,4,2.004335578467616,1.370851684501462
74,52,0,1,20,21,0.33614877658560655,0.22990666911066346
74,53,0,1,11,12,1.6820077546568697,1.150397762024832
74,54,0,2,17,19,1.8993152870069305,1.2990237705521508
74,55,0,1,17,18,2.6931386647866082,1.841953869841158
74,56,0,0,5,5,0.7391022861208808,0.505503980886433
74,57,1,0,5,6,2.5132807244715027,1.7189412550371896
74,58,0,1,10,11,2.894873474886544,1.97992902091816
74,59,1,2,7,10,0.1295531183135257,0.08860697399199682
74,60,0,1,16,17,1.0116226720490276,0.691892445035838
74,61,0,0,2,2,0.06780342472911463,0.04637369111410835
74,62,0,1,3,4,0.13523472095606998,0.09249286747055019
74,63,1,2,8,11,0.08056630626518396,0.055102777121846414
74,64,0,0,8,8,0.6746390994752797,0.46141482288774294
74,65,0,0,7,7,0.7464617874984041,0.5105374617909538
74,66,0,0,6,6,1.0539118699359242,0.7208158542604501
74,67,0,0,5,5,1.1252441141397942,0.7696030574497011
74,68,0,0,4,4,1.5538023227435545,1.0627125289786905
74,69,0,0,3,3,1.8037703214237062,1.2336764412813037
74,70,0,1,15,16,2.0224988096285688,1.3832743028995342
74,71,0,1,14,15,2.227839601966855,1.523715740998944
74,72,0,1,13,14,2.4563772231682983,1.6800224924040543
74,73,0,0,2,2,0.59375,0.40609127354563607
74,75,1,0,4,5,0.21902156403126896,0.14979830883606748
74,76,1,0,5,6,2.6362920691236944,1.803074027433602
74,77,1,1,8,10,0.09553344786248336,0.06533945180409514
74,78,1,1,4,6,8.589097011115841,5.874454473854398
75,0,1,0,0,1,0.0008402865803120777,0.0005747082905974551
75,1,0,0,2,2,1.6679646377023174,1.1407930677113591
75,2,0,1,1,2,0.3494718788912814,0.2390189143028998
75,3,0,1,0,1,0.24386997883060413,0.16679321310798706
75,4,0,1,1,2,0.1847990064049413,0.12639202334475916
75,5,0,0,5,5,0.580559768923427,0.3970699047266941
75,6,0,0,4,4,1.1760744630713142,0.8043681288305349
75,7,0,1,3,4,0.6249199030402172,0.42740971669830263
75,8,0,0,1,1,5.50817761706692,3.76728061209309
75,9,0,0,2,2,9.401262084468456,6.429929251062058
75,10,0,0,3,3,8.794708541996597,6.015081081738243
75,11,0,0,5,5,0.11879833428922272,0.08125131261744953
75,12,0,0,6,6,0.0015041399689602836,0.0010287462999342737
75,13,0,0,4,4,0.004496063691074266,0.003075052177264239
75,14,0,2,23,25,0.24858175522473938,0.17001580052113513
75,15,0,1,5,6,0.4732876346452599,0.3237018582004131
75,16,0,2,1,3,0.8652632868413843,0.5917909391253906
75,17,0,2,1,3,0.4603268691335332,0.3148374307936199
75,18,0,0,3,3,0.40425723726270785,0.2764889874864057
75,19,0,1,4,5,0.0026385143537430277,0.001804593943882016
75,20,0,1,23,24,0.009640981289680427,0.006593883570789006
75,21,0,1,24,25,0.6466015085366232,0.442238703289544
75,22,0,2,27,29,1.1778817286974554,0.8056041958617011
75,23,0,2,28,30,2.0343836198171545,1.3914028379821965
75,24,0,2,25,27,1.1686318284884756,0.799277789535748
75,25,0,2,26,28,0.9559700387987403,0.6538292050985288
75,26,0,3,23,26,0.9233761188108146,0.6315368152412804
75,27,0,2,31,33,1.2145002473011046,0.830649182565045
75,28,0,2,30,32,1.0963055462299025,0.7498107207808762
75,29,0,1,6,7,0.38106412383497357,0.2606262153274886
75,30,0,2,24,26,3.174503229463577,2.17117988939385
75,31,0,2,12,14,0.20855633003206137,0.14264068323153478
75,32,0,1,7,8,0.8386954801854091,0.5736200684891982
75,33,0,1,8,9,0.8828860374374718,0.6038438995177146
75,34,0,3,10,13,0.14448784070333084,0.09882147577780988
75,35,0,0,7,7,0.5446098744592976,0.3724822189552929
75,36,0,1,5,6,0.38571428370660354,0.2638066605392124
75,37,0,2,6,8,0.29358826386362913,0.20079769595020358
75,38,0,2,35,37,1.9213337558513943,1.3140831525388006
75,39,0,2,33,35,0.8255341050749964,0.5646184355120205
75,40,0,2,13,15,0.5821606820870185,0.39816483839480166
75,41,0,0,8,8,1.4296047796367428,0.9777684642182959
75,42,0,1,2,3,0.011857637476727497,0.008109950491228179
75,43,0,2,29,31,0.7763660672428301,0.5309902904998025
75,44,0,1,7,8,0.7293669868398699,0.4988455891670668
75,45,0,1,10,11,1.4203002532154123,0.9714046966659977
75,46,0,1,11,12,0.6440086265812835,0.4404653193141379
75,47,0,1,15,16,2.5963128070484682,1.77573048309416
75,48,0,3,24,27,0.9468872675902616,0.6476171055155819
75,49,0,2,32,34,2.3898235034309585,1.6345035285180152
75,50,0,1,13,14,2.060627819905168,1.4093523801075487
75,51,0,1,6,7,0.8471818068684484,0.5794242338962547
75,52,0,2,34,36,2.021172926792757,1.3823674743532317
75,53,0,2,5,7,0.15502847721510218,0.10603067241788879
75,54,0,3,11,14,0.20328772972320464,0.13903725988967952
75,55,0,2,11,13,0.3123656736096122,0.213640377613588
75,56,0,1,9,10,1.3596276247953,0.92990806518055
75,57,0,0,9,9,3.745765075388471,2.561890542934349
75,58,0,2,4,6,0.2207107502912299,0.15095361628796367
75,59,0,2,3,5,1.0900347190220308,0.7455218311690375
75,60,0,2,10,12,0.08388513961032247,0.057372670612057815
75,61,0,1,12,13,1.3333487425145092,0.9119348024053716
75,62,0,2,11,13,0.857280439568124,0.5863311250357595
75,63,0,2,4,6,1.273746104340263,0.8711699834700295
75,64,0,1,22,23,1.762519562237653,1.205463265142207
75,65,0,1,21,22,1.3860886552648448,0.9480059069703728
75,66,0,1,20,21,1.3834280488894541,0.9461862033385647
75,67,0,1,19,20,1.00768001188257,0.689195889434736
75,68,0,1,18,19,0.8844075632210826,0.6048845367273129
75,69,0,1,17,18,0.6354750377449446,0.4346288292788307
75,70,0,2,9,11,0.4187038316004986,0.28636963741150995
75,71,0,2,8,10,0.21881832023486553,0.14965930162407304
75,72,0,2,7,9,0.19437622811330493,0.1329422989836279
75,73,0,1,16,17,2.599499349796692,1.777909897330512
75,74,0,1,14,15,2.4356371250084417,1.6658374433510899
75,76,0,0,1,1,0.2103668822023824,0.14387899807223625
75,77,0,1,4,5,1.863728013528394,1.2746840969371351
75,78,0,1,8,9,4.495458856089931,3.074638504491062
76,0,1,0,0,1,0.0009232409654648623,0.0006314443780296902
76,1,0,0,1,1,1.7969002003495,1.228977668706252
76,2,0,1,0,1,0.04224140646040429,0.02889072260356116
76,3,0,1,1,2,0.16653748437106522,0.11390217957277023
76,4,0,1,2,3,0.4044101530465898,0.27659357319658984
76,5,0,0,4,4,0.6615979925805741,0.4524954465385796
76,6,0,0,3,3,1.3184067126304093,0.9017153027085444
76,7,0,1,2,3,0.6782600761845133,0.4638913652765122
76,8,0,0,2,2,5.909386356250368,4.04168460005544
76,9,0,0,3,3,10.014430656480517,6.849301724841487
76,10,0,0,4,4,9.339965146653935,6.388005627413135
76,11,0,0,6,6,0.1257275707742708,0.0859905167756172
76,12,0,0,7,7,0.0016357540640066957,0.0011187628649430381
76,13,0,0,5,5,0.005117459123871721,0.003500051356515034
76,14,0,2,24,26,0.2759403693614087,0.18872753855432028
76,15,0,1,6,7,0.4977440725441176,0.3404286725376542
76,16,0,2,0,2,0.15920810978785666,0.10888930368428487
76,17,0,2,2,4,0.8985755485928413,0.614574633945323
76,18,0,0,2,2,0.43884473130368407,0.3001448687560514
76,19,0,1,5,6,0.005149023532685841,0.0035216396192081566
76,20,0,1,24,25,0.010730278976514275,0.007338901313806562
76,21,0,1,25,26,0.6872761695004893,0.4700578609684549
76,22,0,2,28,30,1.2697616563000378,0.8684448473369237
76,23,0,2,29,31,2.1722734194845454,1.485711628476316
76,24,0,2,26,28,1.2813898965822026,0.8763979031773937
76,25,0,2,27,29,1.0385381500854673,0.7103011031476821
76,26,0,3,24,27,1.025172674404502,0.7011598769736588
76,27,0,2,32,34,1.3099943013022783,0.8959616912056722
76,28,0,2,31,33,1.1920326506760535,0.8152826226880316
76,29,0,1,7,8,0.4683428003674887,0.3203198724331167
76,30,0,2,25,27,3.390709278516012,2.319052545912542
76,31,0,2,13,15,0.2203567902077933,0.15071152769669277
76,32,0,1,8,9,0.9910011865194888,0.677788520284523
76,33,0,1,9,10,1.0113085078052015,0.6916775745383598
76,34,0,3,11,14,0.31833442408190094,0.2177226638969865
76,35,0,0,8,8,0.5570260049088013,0.38097414691613113
76,36,0,1,6,7,0.5105456954703401,0.3491842554556512
76,37,0,2,7,9,0.44052340924120037,0.3012929891122938
76,38,0,2,36,38,2.053760077630094,1.404655234495982
76,39,0,2,34,36,0.9561821669638861,0.6539742887140892
76,40,0,2,14,16,0.7980597372432298,0.5458275285264823
76,41,0,0,9,9,1.4707984321859717,1.0059425826616017
76,42,0,1,3,4,0.1846752237621629,0.12630736304825604
76,43,0,2,30,32,0.8516697413980395,0.5824937261888208
76,44,0,1,8,9,0.8575758862506372,0.5865331937845031
76,45,0,1,11,12,1.5827207135729482,1.0824910656705622
76,46,0,1,12,13,0.7037426928770045,0.48132002761912945
76,47,0,1,16,17,2.7619158228203986,1.8889935392252275
76,48,0,3,25,28,1.0509677278212106,0.7188022282884696
76,49,0,2,33,35,2.5533741182512015,1.74636285897953
76,50,0,1,14,15,2.2302091355091243,1.5253363673465468
76,51,0,1,7,8,1.0002169903464837,0.6840916066219566
76,52,0,2,35,37,2.2069608061766752,1.5094358306452036
76,53,0,2,6,8,0.3103584552306335,0.21226755425728713
76,54,0,3,12,15,0.3786221228238569,0.25895602534752377
76,55,0,2,12,14,0.3045793739591083,0.20831499093353567
76,56,0,1,10,11,1.5321649995345856,1.0479138289567138
76,57,0,0,10,10,3.9211044362526226,2.6818127060602457
76,58,0,2,5,7,0.08336936937105367,0.05701991306541092
76,59,0,2,2,4,1.1865332159858546,0.8115213217412967
76,60,0,2,11,13,0.17168063570671802,0.11741980294276295
76,61,0,1,13,14,1.4481715556869823,0.9904670843983018
76,62,0,2,12,14,0.9387212156232313,0.6420319898218874
76,63,0,2,3,5,1.3786721733070728,0.9429334545855984
76,64,0,1,23,24,1.9647016605062253,1.343744335919493
76,65,0,1,22,23,1.5632908155004699,1.0692021190547902
76,66,0,1,21,22,1.5864051443082736,1.0850110070088343
76,67,0,1,20,21,1.185886290478692,0.8110788614413509
76,68,0,1,19,20,1.0891850802460583,0.7449407265078359
76,69,0,1,18,19,0.8418108858894857,0.5757508290281118
76,70,0,2,10,12,0.6270692785506565,0.42887976745764933
76,71,0,2,9,11,0.42917554148409165,0.2935316921531162
76,72,0,2,8,10,0.12918346664939578,0.08835415325085191
76,73,0,1,17,18,2.7643960294530356,1.8906898596801396
76,74,0,1,15,16,2.6362920691236944,1.803074027433602
76,75,0,0,1,1,0.018916973750836476,0.012938135515126823
76,77,0,1,3,4,2.017364099251947,1.3797624526660515
76,78,0,1,9,10,5.2978381988251035,3.623420397809861
77,0,2,0,0,2,0.0007052759473097737,0.0004823686865585363
77,1,1,0,1,2,0.0995119068727581,0.06806049178090622
77,2,1,1,2,4,4.041815814353803,2.7643724319794996
77,3,1,1,3,5,4.242628850585451,2.901717142089606
77,4,1,1,4,6,4.401061181804755,3.0100758572991237
77,5,1,0,2,3,0.416744422005923,0.2850295125480847
77,6,1,0,1,2,0.5685736125983696,0.38887205464339364
77,7,0,0,1,1,0.027600721301177453,0.018877325581428742
77,8,1,0,4,5,0.6292623255687292,0.4303796870475686
77,9,1,0,5,6,1.9465390503895261,1.331322142280414
77,10,1,0,6,7,2.168152211350393,1.4828929562072728
77,11,1,0,8,9,0.060570059071709856,0.04142647987733063
77,12,1,0,9,10,0.0013366759433092019,0.0009142104187557864
77,13,1,0,7,8,0.002858232115276547,0.001954868412263899
77,14,1,2,26,29,0.07999975641261102,0.054715289204105885
77,15,1,1,8,10,0.29608625658366333,0.20250618107860174
77,16,1,2,2,5,9.701034452286233,6.634956522844645
77,17,1,2,4,7,9.683051564631151,6.622657249160636
77,18,1,0,0,1,0.01722814324430494,0.01178307137836874
77,19,1,1,7,9,0.03191197564822695,0.021825978665003465
77,20,1,1,26,28,0.0034570753086492997,0.002364443140770639
77,21,1,1,27,29,0.17621661646498424,0.1205221561265993
77,22,1,2,30,33,0.13882918827093874,0.09495127893937245
77,23,1,2,31,34,0.44229190631850557,0.30250254065820475
77,24,1,2,28,31,0.20379721011381702,0.13938571553712426
77,25,1,2,29,32,0.09592900213676614,0.06560998845925287
77,26,1,3,26,30,0.29573302942241336,0.20226459376447478
77,27,1,2,34,37,0.17225022173828655,0.11780936743447408
77,28,1,2,33,36,0.1483268959277297,0.10144717148355836
77,29,1,1,9,11,0.6576473432315499,0.449793426790407
77,30,1,2,27,30,0.6370018744224175,0.4356730988381589
77,31,1,2,15,18,1.3667358634405087,0.9347696966485065
77,32,1,1,10,12,1.7420546300846709,1.1914664140078415
77,33,1,1,11,13,0.6522629368402825,0.4461107986662518
77,34,1,3,13,17,2.175498825301657,1.4879176228442694
77,35,1,0,10,11,0.7535706783792875,0.5153995393510632
77,36,1,1,8,10,1.0934748051424366,0.747874654670077
77,37,1,2,9,12,1.438269316376735,0.9836945151815403
77,38,1,2,38,41,0.4568988108091335,0.31249283362184027
77,39,1,2,36,39,0.743387776199252,0.5084350126737052
77,40,1,2,16,19,2.201067655959329,1.5054052506419064
77,41,1,0,11,12,1.9069241566902964,1.3042278052131375
77,42,1,1,5,7,1.9808799710062213,1.3548093813338253
77,43,1,2,32,35,0.1567371671901546,0.1071993193030487
77,44,1,1,10,12,0.800881507992436,0.5477574594354488
77,45,1,1,13,15,0.5275970710657759,0.3608464278030288
77,46,1,1,14,16,0.0756982313018093,0.051773290365480194
77,47,1,1,18,20,0.6133097374240885,0.4194690229027161
77,48,1,3,27,31,0.3119206747639262,0.21333602368016324
77,49,1,2,35,38,0.5378054424023162,0.3678283739367256
77,50,1,1,16,18,0.077373856878089,0.052919323080018406
77,51,1,1,9,11,2.010808467866705,1.3752787731744662
77,52,1,2,37,40,0.4122572012712452,0.281960508450694
77,53,1,2,8,11,1.6526894097967528,1.130345679494314
77,54,1,3,14,18,1.8719413758082304,1.2803015701974472
77,55,1,2,14,17,2.663450195169559,1.821648643000891
77,56,1,1,12,14,0.7072427501871671,0.4837138680074523
77,57,1,0,12,13,2.6230127716044387,1.7939917422270568
77,58,1,2,7,10,2.8518555056431736,1.9505071734817183
77,59,0,1,1,2,0.08905237063266207,0.060906763119959136
77,60,1,2,13,16,0.9974038772860377,0.6821675970803239
77,61,1,1,15,17,0.06452425401108523,0.04413092460790521
77,62,1,2,14,17,0.12287533156593317,0.08403974717128773
77,63,0,1,2,3,0.015058465048420854,0.01029913473542008
77,64,1,1,25,27,0.6498258204617414,0.44444394949750976
77,65,1,1,24,26,0.7218428699559551,0.4936995206067381
77,66,1,1,23,25,1.0234125493531285,0.6999560514179335
77,67,1,1,22,24,1.0969887872781847,0.7502780188481362
77,68,1,1,21,23,1.5201204239521047,1.0396760234196925
77,69,1,1,20,22,1.7691700121491307,1.2100117951198128
77,70,1,2,12,15,1.9872841944190454,1.3591895063726207
77,71,1,2,11,14,2.1921597599776588,1.499312755780755
77,72,1,2,10,13,2.4224222052065527,1.656799188846412
77,73,1,1,19,21,0.6340846031510994,0.4336778509967313
77,74,1,1,17,19,0.12282871868033575,0.08400786660526519
77,75,1,0,3,4,0.2154771850245594,0.14737415492488756
77,76,1,0,2,3,2.59375384189536,1.7739802962849232
77,78,1,1,11,13,8.641755076131684,5.910469599218157
78,0,2,0,0,2,0.0004203737223045416,0.00028751174779919307
78,1,1,0,8,9,1.384465872034885,0.9468960154191428
78,2,1,1,7,9,1.9114070850431328,1.3072938735651667
78,3,1,1,6,8,1.978335514908946,1.3530691178946281
78,4,1,1,7,9,2.0218058580558314,1.3828003633851285
78,5,1,0,11,12,0.4926688107250951,0.3369574817407458
78,6,1,0,10,11,0.9707154237821859,0.6639142108532206
78,7,1,1,9,11,0.5153226097337925,0.35245139347142157
78,8,1,0,5,6,4.596407598322559,3.1436817100423515
78,9,1,0,4,5,7.940986645519623,5.431183798042866
78,10,1,0,3,4,7.469992808705337,5.109050767265504
78,11,1,0,1,2,0.08958932720533973,0.06127401091522207
78,12,1,0,0,1,0.0007893150502182889,0.0005398466593210654
78,13,1,0,2,3,0.0031907729150142013,0.0021823074301524858
78,14,1,2,21,24,0.1823472339992179,0.12471515028592255
78,15,1,1,1,3,0.3572355106678092,0.24432879744474323
78,16,1,2,7,10,4.630252272944867,3.16682954502359
78,17,1,2,7,10,4.493116866224794,3.073036716454069
78,18,1,0,9,10,0.33232141674773163,0.22728897238497078
78,19,1,1,2,4,0.011502986837565897,0.007867389599066651
78,20,1,1,21,23,0.006945836530493537,0.0047505576463291324
78,21,1,1,22,24,0.5312391205368592,0.36333738276391875
78,22,1,2,25,28,0.9359118694867478,0.6401105566422746
78,23,1,2,26,29,1.6533635749922373,1.130806770193791
78,24,1,2,23,26,0.8900027314922745,0.6087113140055452
78,25,1,2,24,27,0.7441232070705678,0.5089380056154104
78,26,1,3,21,25,0.6844453463197521,0.46812173871052126
78,27,1,2,29,32,0.9507957650334564,0.6502902957544987
78,28,1,2,28,31,0.8373458087745004,0.5726969699087789
78,29,1,1,4,6,0.36035496286557184,0.24646232555548708
78,30,1,2,22,25,2.600803076802931,1.778801572547892
78,31,1,2,10,13,0.48927178106908237,0.33463410641563834
78,32,0,0,1,1,0.06142229709533103,0.04200936227628025
78,33,1,1,6,8,0.6963183062892065,0.47624216891641963
78,34,1,3,8,12,0.813306223933451,0.556255259384804
78,35,1,0,1,2,0.41761134829784835,0.28562244088822475
78,36,1,1,3,5,0.4903890787891268,0.33539827459090144
78,37,1,2,4,7,0.5988477489569459,0.4095778442675595
78,38,1,2,33,36,1.5280934017410208,1.045129087342643
78,39,1,2,31,34,0.4897187558962217,0.33493981180813664
78,40,1,2,11,14,0.5465986641515577,0.37384243813667273
78,41,1,0,2,3,1.057489142346009,0.7232625053911128
78,42,1,1,8,10,0.8372848698983926,0.5726552911789986
78,43,1,2,27,30,0.576892847920628,0.3945619390508745
78,44,1,1,5,7,0.602212083902694,0.4118788582679856
78,45,1,1,8,10,1.1129869234763936,0.7612198352743882
78,46,1,1,9,11,0.5125747641943454,0.3505720232067972
78,47,1,1,13,15,2.1722380094781677,1.4856874100433288
78,48,1,3,22,26,0.6817566079458881,0.4662827943897239
78,49,1,2,30,33,1.9220143159228147,1.314548616970173
78,50,1,1,11,13,1.6645572480949675,1.1384626067680077
78,51,0,0,2,2,0.19376120039310699,0.13252165495809348
78,52,1,2,32,35,1.4835053083828182,1.0146333641985517
78,53,1,2,3,6,0.6809342901062857,0.46572037569710345
78,54,1,3,9,13,0.677662525106623,0.4634826742816001
78,55,1,2,9,12,1.0332139138317569,0.7066596279798049
78,56,1,1,7,9,1.0644504374219639,0.7280236358044543
78,57,1,0,3,4,2.848860122926361,1.9484585018484937
78,58,1,2,2,5,1.267242193812129,0.866721678106835
78,59,1,2,9,12,0.896397506430736,0.6130849768245727
78,60,1,2,8,11,0.366274562287438,0.25051099531229654
78,61,1,1,10,12,1.0707707350907991,0.7323463604015485
78,62,1,2,9,12,0.6809188007561111,0.4657097818614171
78,63,1,2,10,13,1.0515685832416122,0.7192131792659645
78,64,1,1,20,22,1.345347146470124,0.920141029172278
78,65,1,1,19,21,1.049731556319058,0.7179567571985663
78,66,1,1,18,20,1.0480760510578517,0.7168244856366554
78,67,1,1,17,19,0.7851513914650673,0.5369989532398778
78,68,1,1,16,18,0.7750455158622385,0.5300871083660309
78,69,1,1,15,17,0.7343783923065377,0.5022731058461619
78,70,1,2,7,10,0.7669026979263632,0.5245178834298966
78,71,1,2,6,9,0.8491594827642022,0.5807768518721153
78,72,1,2,5,8,1.0346115246528256,0.7076155143936979
78,73,1,1,14,16,2.169725893035409,1.4839692650908491
78,74,1,1,12,14,1.9555533373522673,1.3374874025293493
78,75,1,0,6,7,0.09203869998417762,0.06294924276557372
78,76,1,0,7,8,1.2062042327682154,0.8249751798584951
78,77,1,1,10,12,1.5303107947316523,1.046645658194882
